abbar7	i76building
abbarr	barracks
abcafe	i76building
abcomm	commtower
abhang	repairdepot
abhqc3	i76building
abhqcp	i76building
ablpad	i76building
ablpow	powerplant
abmbld	supplydepot
abshld	i76building
absilo	scrapsilo
absiloa	scrapsilo
abspow	powerplant
abspowa	powerplant
abstor	i76building
abstora	i76building
absupp	supplydepot
abtowe	turret
abtowe02	turret
abtowe03	turret
abtowe2	turret
abwpow	powerplant
abwpowa	powerplant
ammomina	ammopack
ammomine	ammopack
anchor	anchor
apammo	ammopack
apammoa	ammopack
apammob	ammopack
apartl	wpnpower
apbase	camerapod
apblst	wpnpower
apblstb	wpnpower
apblstg	wpnpower
apbltm	wpnpower
apbltmg	wpnpower
apbltmr	wpnpower
apbolt	wpnpower
apboltg	wpnpower
apboltr	wpnpower
apbsstb	wpnpower
apcamr	camerapod
apcmet	wpnpower
apdrop	camerapod
apflar	wpnpower
apflsh	wpnpower
apflshb	wpnpower
apflshg	wpnpower
apgmini	wpnpower
aphartl	wpnpower
aphorn	wpnpower
apmagg	wpnpower
apmasg	wpnpower
apmcur	wpnpower
apmdmg	wpnpower
apmini	wpnpower
apmits	wpnpower
apmort	wpnpower
apphan	wpnpower
appopg	wpnpower
approx	wpnpower
apredf	wpnpower
aprepa	repairkit
aprepaa	repairkit
aprepab	repairkit
aprktb	wpnpower
apsand	wpnpower
apscrap	camerapod
apshdw	wpnpower
apsite	wpnpower
apspln	wpnpower
apsplng	wpnpower
apsplnr	wpnpower
apsstb	wpnpower
apsstba	wpnpower
apstab	wpnpower
aptagg	wpnpower
aptech	wpnpower
apthmp	wpnpower
apwrck	daywrecker
apwrcka	daywrecker
apwrckb	daywrecker
aspilo	person
assold	person
asuser	person
asusera	person
avapc	apc
avarmp	howitzer
avartl	howitzer
avartla	howitzer
avcns7	constructionrig
avcns8	constructionrig
avcns9	constructionrig
avcnst	constructionrig
avdemo	wingman
avfigh	wingman
avfimp	wingman
avhaul	tug
avhraz	wingman
avhrmp	wingman
avlamp	turrettank
avland	turret
avltmp	wingman
avltnk	wingman
avmine	minelayer
avmu7	factory
avmu8	factory
avmuf	factory
avmuf4	factory
avmuf5	factory
avmuf6	factory
avrckt	wingman
avrec2	recycler
avrec3	recycler
avrec4	recycler
avrec5	recycler
avrec6	recycler
avrec7	recycler
avrec8	recycler
avrecy	recycler
avremp	recycler
avret3	recycler
avret4	recycler
avsav	sav
avscab	scavenger
avscav	scavenger
avsl7	armory
avsl8	armory
avslf	armory
avslf5	armory
avslf6	armory
avtam2	wingman
avtamp	wingman
avtank	wingman
avtest	turrettank
avtump	turrettank
avturr	turrettank
avwalk	walker
avwamp	walker
bbbarr	barracks
bbcafe	i76building
bbcom2	commtower
bbcomm	commtower
bbhang	repairdepot
bbhanga	repairdepot
bbhqcp	i76building
bblpad	i76building
bblpow	powerplant
bbmbld	supplydepot
bbshld	i76building
bbsilo	scrapsilo
bbspow	powerplant
bbstor	i76building
bbsupp	supplydepot
bbtowe	turret
bbwpow	powerplant
blast	bolt
blastb	bolt
blastg	bolt
bolt	bolt
boltg	bolt
boltmine	weaponmine
boltming	weaponmine
boltminr	weaponmine
boltr	bolt
bouncebm	bouncebomb
bsheav	person
bspilo	person
bssold	person
bsuser	person
bullet1	tracer
bullet1a	tracer
bullet1b	tracer
bullet1g	tracer
bullet2	tracer
bullet5	tracer
bullet6	tracer
bullet6a	tracer
bv0001	armory
bv0002	wingman
bvapc	apc
bvapca	apc
bvapcb	recycler
bvartl	howitzer
bvcnst	constructionrig
bvfigh	wingman
bvfigha	wingman
bvhapc	apc
bvhaul	tug
bvhraz	wingman
bvhraza	wingman
bvltnk	wingman
bvltnka	wingman
bvmine	minelayer
bvmru	minelayer
bvmuf	factory
bvmufa	factory
bvmufb	factory
bvra8	wingman
bvraz	wingman
bvrckt	wingman
bvrdev	wingman
bvrdeva	wingman
bvrec3	recycler
bvrec8	recycler
bvrecy	recycler
bvrecya	recycler
bvrecyb	recycler
bvrecyc	recycler
bvrecyd	recycler
bvrecye	recycler
bvremp	recycler
bvrmpa	wingman
bvrmpb	wingman
bvsca8	scavenger
bvscav	scavenger
bvslf	armory
bvslfa	armory
bvslfb	armory
bvslfc	armory
bvslfd	armory
bvtank	wingman
bvtanka	wingman
bvtump	turrettank
bvtur8	turrettank
bvturr	turrettank
bvwalk	walker
cbbarr	barracks
cbcafe	i76building
cbcomm	commtower
cbhang	repairdepot
cbhanga	repairdepot
cbhqcp	i76building
cblasr	turret
cblpad	i76building
cblpada	i76building
cblpow	powerplant
cbmbld	supplydepot
cbmblda	supplydepot
cbport	portal
cbshld	i76building
cbsilo	scrapsilo
cbsiloa	scrapsilo
cbspow	powerplant
cbspowa	powerplant
cbsupp	supplydepot
cbtowe	turret
cbtowea	turret
cbtoweb	turret
cbtowec	turret
cbtowed	turret
cbtowee	turret
cbtowef	turret
cbwpow	powerplant
cbwpowa	powerplant
charge1	flamepuff
charge2	flamepuff
charge3	flamepuff
charge4	flamepuff
charge5	flamepuff
charge6	flamepuff
cpcamr	camerapod
cpsstb	wpnpower
cpsstba	wpnpower
cspilo	person
cspiloa	person
cssold	person
cssolda	person
csuser	person
csusera	person
csuserb	person
cvapc	apc
cvapca	apc
cvapcb	recycler
cvapcc	apc
cvartl	howitzer
cvartla	howitzer
cvcnst	constructionrig
cvfigh	wingman
cvfigha	wingman
cvfighb	wingman
cvfighc	recycler
cvfighd	wingman
cvfighe	wingman
cvfighf	wingman
cvfighg	wingman
cvfighh	recycler
cvfimp	wingman
cvhaul	tug
cvhaula	tug
cvhmpa	wingman
cvhmpb	wingman
cvhraz	wingman
cvhraza	wingman
cvhrazb	wingman
cvhtnk	wingman
cvhzmp	wingman
cvltnk	wingman
cvmine	minelayer
cvminea	minelayer
cvmuf	factory
cvmufa	factory
cvmufb	factory
cvmufc	factory
cvmump	factory
cvraz	wingman
cvrckt	wingman
cvrecy	recycler
cvrecya	recycler
cvrecyd	recycler
cvrecye	recycler
cvremp	recycler
cvscav	scavenger
cvscava	scavenger
cvscavb	scavenger
cvslf	armory
cvslfa	armory
cvslfb	armory
cvtank	wingman
cvtmpa	wingman
cvtnk	wingman
cvtnka	wingman
cvtnkb	wingman
cvtnkc	wingman
cvtnkd	wingman
cvturr	turrettank
cvturra	turrettank
cvturrb	turrettank
cvturrc	turrettank
cvwalk	walker
cvwamp	walker
cvwo003	mortar
cvwo004	grenade
dayquake	seismic
dummy	tracer
eggeizr1	geyser
flame	flamepuff
flare	flare
flash	beam
flashb	beam
flashch	beam
flashg	beam
ga7stab	cannon
gammo	dispenser
gammoa	dispenser
gatstab	cannon
gatstaba	cannon
gblast	cannon
gblastb	cannon
gblastg	cannon
gbolt	cannon
gboltg	cannon
gboltmig	dispenser
gboltmin	dispenser
gboltmir	dispenser
gboltr	cannon
gbspstab	cannon
gcomet	radarlauncher
gdummy	machinegun
gflare	dispenser
gflashch	beamgun
gflashgb	beamgun
gflashgg	beamgun
gflashgn	beamgun
ghartila	mortar
ghartill	mortar
ghartmp	mortar
ghornet	thermallauncher
ghrntai	thermallauncher
gmaggun	chargegun
gmasgren	cannon
gmbolt	beamgun
gmboltg	beamgun
gmboltr	beamgun
gmcurmin	dispenser
gmdmgun	detonator
gminigna	machinegun
gminignb	machinegun
gminignc	machinegun
gminigrn	machinegun
gminigun	machinegun
gminisov	machinegun
gmitsmin	dispenser
gmortar	mortar
gnavdrop	dispenser
gobject	lobber
gphantom	imagerefract
gpopgun	poppergun
gproxmin	dispenser
gquake	cannon
gredfld	radardamper
grenade	grenade
grepa	dispenser
grepaa	dispenser
grktbomb	cannon
gsandbag	cannon
gshadow	imagelauncher
gsitecam	terrainexpose
gsnipe	snipergun
gsplint	mortar
gsplinta	mortar
gsplintg	mortar
gsplintr	mortar
gspstab	cannon
gspstaba	cannon
gspstabb	cannon
gspstabc	cannon
gspstabd	cannon
gtaggun	targeting
gtechno	machinegun
gtminig	machinegun
gtminis	machinegun
gtminisa	machinegun
gwasp	dispenser
handgun	cannon
hbblda	i76building
hbbldb	i76building
hbbldc	i76building
hbbldd	i76building
hbblde	i76building
hbbldf	i76building
hbcerb	i76building
hbchar	i76building
hbcrys	i76building
hbdayw	i76building
hbelec	i76building
hbfact	i76building
hbfacta	i76building
hbflsh	i76building
hbhydr	i76building
hbmasg	i76building
hbpopg	i76building
hbptow	i76building
hbpvir	i76building
hbsbmi	i76building
hbspln	i76building
hbtran00	i76building
hbtrn200	i76building
heatmsl	thermalmissile
hocrys	i76building
hvsat	wingman
hvsav	sav
hvsrb	artifact
imagemsl	imagemissile
magpull	magnet
magpulla	magnet
magpush	magnet
mbolt	beam
mboltg	beam
mboltr	beam
nparr	i76sign
npscr1	scrap
npscr2	scrap
npscr3	scrap
nvghst	wingman
obcmmi	i76building
obcurt	i76building
obcycl	i76building
obdata	artifact
obdataa	artifact
obhavc	i76building
obheph	i76building
obher100	i76building
obher200	i76building
obher300	i76building
oblema	i76building
oblemb	i76building
oblemc	i76building
oblemd	i76building
obmagc	i76building
obmits	i76building
obrfld	i76building
obstp1	i76building
obstp2	i76building
obstp3	i76building
obstp4	i76building
obstp5	i76building
obstp6	i76building
obstp7	i76building
obstp8	i76building
obtags	i76building
plasma	rocket
player	wingman
playrt	wingman
playsv	wingman
popper	popper
poproc	rocket
proxmina	proximity
proxminb	proximity
proxminc	proximity
proxmind	proximity
proxmine	proximity
proxminf	proximity
pspwn_1	spawnpnt
radarmsl	torpedo
repamina	repairkit
repamine	repairkit
rocket	bullet
rocket2	rocket
rocket3	rocket
rocket3a	rocket
rocket3b	rocket
rocket3c	rocket
rocket3d	rocket
rocketa	rocket
rocketb3	rocket
savmf	factory
savs8	sav
savtnk	wingman
sb0002	turret
sbbarr	barracks
sbbarra	powerplant
sbcafe	i76building
sbcom7	commtower
sbcomm	commtower
sbhang	repairdepot
sbhanga	repairdepot
sbhqcp	i76building
sbhqt1	i76building
sbhqt2	i76building
sblpad	i76building
sblpd2	i76building
sblpow	powerplant
sblpowa	powerplant
sblpowb	powerplant
sbmbld	supplydepot
sbmblda	supplydepot
sbmbldb	supplydepot
sbshld	i76building
sbsilo	scrapsilo
sbsiloa	scrapsilo
sbspow	powerplant
sbspowa	powerplant
sbsupp	supplydepot
sbtowe	turret
sbtowea	turret
sbtoweb	turret
sbtowec	turret
sbtowed	turret
sbtowee	turret
sbwpow	powerplant
sbwpowa	powerplant
seismic	seismic
sfield	scrapfield
shell	grenade
shella	grenade
snipe	snipershell
spammo	ammopack
spartl	wpnpower
spblst	wpnpower
spbolt	wpnpower
spcamr	camerapod
spcmet	wpnpower
spflar	wpnpower
spflsh	wpnpower
sphorn	wpnpower
splintb2	spraybomb
splintbg	spraybomb
splintbm	spraybomb
splintbr	spraybomb
splinter	tracer
splintg2	spraybomb
splintr2	spraybomb
splintrg	tracer
splintrr	tracer
splntbma	spraybomb
spmagg	wpnpower
spmasg	wpnpower
spmcur	wpnpower
spmdmg	wpnpower
spmini	wpnpower
spmits	wpnpower
spmort	wpnpower
spphan	wpnpower
sppopg	wpnpower
spprox	wpnpower
spredf	wpnpower
sprepa	repairkit
sprktb	wpnpower
spsand	wpnpower
spshdw	wpnpower
spsite	wpnpower
spspln	wpnpower
spsstb	wpnpower
spstab	wpnpower
sptagg	wpnpower
sptech	wpnpower
spthmp	wpnpower
sscr_1	scrap
sspilo	person
sssold	person
ssuser	person
ssusera	person
ssuserb	person
ssuserc	person
svap2	tug
svap7	tug
svapc	apc
svapc13	apc
svapca	apc
svapcb	apc
svapcc	apc
svapcd	apc
svapce	apc
svapcf	apc
svapcg	apc
svapch	apc
svapci	apc
svapcj	apc
svapck	apc
svapcl	apc
svapcm	apc
svapcn	apc
svapco	apc
svapcp	apc
svapcq	apc
svapcr	apc
svapcs	apc
svarmp	howitzer
svartl	howitzer
svartla	howitzer
svcnst	constructionrig
svdemo	wingman
svfi12	wingman
svfigh	wingman
svfigha	wingman
svfimp	wingman
svhaul	tug
svhaula	tug
svhaulb	tug
svhr13	wingman
svhraz	wingman
svhrmp	wingman
svlt13	wingman
svltnk	wingman
svltnka	wingman
svmfs8	factory
svmine	minelayer
svmuf	factory
svmuf13	factory
svrckt	wingman
svrecy	recycler
svremp	recycler
svsav	sav
svscav	scavenger
svscava	scavenger
svslf	armory
svtamp	wingman
svtank	wingman
svtanka	wingman
svtas8	wingman
svtk13	wingman
svtnk7	wingman
svtump	turrettank
svturr	turrettank
svturra	turrettank
svturrb	turrettank
svturrc	turrettank
svwalk	walker
svwalka	walker
svwamp	walker
svwatm	walker
swarmer	missile
switch	switcher
tracer	tracer
ubtart	i76building
waspmsl	torpedo
xbldxpl	explosion
xbldxpla	explosion
xbmbxpl	quakeblast
xbulbld	explosion
xbulcar	explosion
xbulgnd	groundblast
xcarxpl	explosion
xcarxpla	explosion
xcarxplb	explosion
xgasgnd	explosion
xgasxpl	explosion
xgndshk	planarexpl
xlasbld	explosion
xlascar	explosion
xlascar2	explosion
xlasgnd	planarexpl
xlgtbld	explosion
xlgtbldg	explosion
xlgtbldr	explosion
xlgtcar	explosion
xlgtcarg	explosion
xlgtcarr	explosion
xlgtgnd	planarexpl
xlgtgndg	planarexpl
xlgtgndr	planarexpl
xminxpl	explosion
xmslbld	explosion
xmslcar	explosion
xmslgnd	planarexpl
xpltrsa	quakeblast
xpltrsb	explosion
xpltrsc	explosion
xpltrsd	explosion
xpltrse	quakeblast
xpltrsf	explosion
xpltrsg	explosion
xpltrsh	explosion
xpltrsi	planarexpl
xpltrsj	explosion
xpltrsk	quakeblast
xpltrsl	explosion
xpltrsm	explosion
xpltrsn	explosion
xpltrso	explosion
xpltrsp	explosion
xpltrsq	explosion
xpltrsr	explosion
xpltrss	explosion
xpopfir	explosion
xsecxpl	explosion
xsecxpla	explosion
xtorxpl	shockblast
xtorxpla	explosion
xtorxplb	explosion
aetar0	wingman
aetar1	recycler
aetar10	factory
aetar11	wingman
aetar2	wingman
aetar8	recycler
getar0	wingman
getar1	recycler
getar10	factory
getar11	wingman
getar12	factory
getar13	turrettank
getar14	turrettank
getar15	weaponmine
getar16	weaponmine
getar17	artifact
getar18	scrapsilo
getar19	factory
getar2	wingman
getar20	factory
getar21	recycler
getar22	weaponmine
getar23	sav
getar24	magnet
getar3	turrettank
getar5	constructionrig
getar6	supplydepot
getar7	repairdepot
getar8	recycler
getar9	walker
hetar4	wingman
abchrg	artifact
abchrga	i76building
abgeosh	shieldtower
abpris	i76building
abshtr	i76building
abtlab	i76building
abtrdc	i76building
acid	flamepuff
acidbm	spraybomb
apacld	wpnpower
apaltr	wpnpower
aparcc	wpnpower
apcrickt	wpnpower
apfafmsl	wpnpower
apiong	wpnpower
apminifl	wpnpower
appexg	wpnpower
applsc	wpnpower
apseek	wpnpower
apskmn	wpnpower
apspne	wpnpower
apstng	wpnpower
apthrw	wpnpower
apvltr	wpnpower
arcc	bolt
coilbolt	beam
cricket	tracer
fafmsl	thermalmissile
fbbarr	barracks
fbtowe	turret
fspilo	person
fssold	person
fsuser	person
fvartl	howitzer
fvbapc	apc
fvbfig	wingman
fvbhra	wingman
fvbltn	wingman
fvbrck	wingman
fvbtan	wingman
fvbtur	turrettank
fvcnst	constructionrig
fvhaul	tug
fvmine	minelayer
fvmuf	factory
fvrecy	recycler
fvremp	recycler
fvscav	scavenger
fvslf	armory
fvtump	turrettank
fvwalk	walker
gacidcl	mortar
galtbomb	cannon
garcc	cannon
gcolbolt	beamgun
gcricket	cannon
gfafmsl	cannon
giongun	machinegun
gminifls	beamgun
gpexgun	cannon
gplasca	cannon
gseeker	dispenser
gseekmin	dispenser
gspine	cannon
gspjump	dispenser
gstngr	cannon
gthrower	mortar
ionbull	tracer
jumppad	magnet
miniflsh	beam
pexgun	flamepuff
plasca	rocket
plsmthwr	grenade
seeker	torpedo
seekmin	weaponmine
spine	rocket
stngr	thermalmissile
thmpmine	weaponmine
trnsdcr	weaponmine
xmflbld	explosion
xmflcar	explosion
xmflgnd	planarexpl
apb2bu	wpnpower
bsb2br	person
gb2bst	cannon
hvb2b	artifact
svb2ba	recycler
svb2bb	factory
svb2bc	wingman
svb2bd	turrettank
svb2be	wingman
svrwtk	wingman
bullet56	tracer
gtautcan	machinegun
sbtwac	turret
spautcan	wpnpower
cvfibz	wingman
cvrebz1	recycler
cvrebz2	recycler
cvrebz3	recycler
cvrebz4	recycler
cvscabz	scavenger
cvtubz	turrettank
cvwabz1	walker
cvwabz2	walker
cvwabz3	walker
cvwabz4	walker
cspilb	person
avmuf4	recycler
avscav01	scavenger
avtank01	wingman
avturr01	turrettank
avturr02	turrettank
avwalk01	walker
bvmuf2	recycler
bvscav01	scavenger
bvtank01	wingman
bvturr01	turrettank
bvturr02	turrettank
bvwalk01	walker
cvmuf1	recycler
cvscav01	scavenger
cvtank01	wingman
cvturr01	turrettank
cvturr02	turrettank
cvwalk01	walker
super1	wingman
svart1	howitzer
svmuf3	recycler
svrebz1	recycler
svscav01	scavenger
svtank01	wingman
svturr01	turrettank
svwalk01	walker
avfigh01	wingman
avltnk01	wingman
avmuf01	factory
avrecy01	recycler
avhraz01	wingman
bvcnst01	constructionrig
bvltnk01	wingman
bvmuf01	factory
bvmuf201	factory
bvraz01	wingman
bvrecy01	recycler
bvslf01	armory
bvslf101	armory
abhang01	repairdepot
absupp01	supplydepot
avmuf02	recycler
avmuf03	recycler
avmuf04	recycler
avrckt01	wingman
gmortars	mortar
gproto1	cannon
gquakeb	cannon
grenadeb	grenade
rocket2f	rocket
avtanka	wingman
svtur001	turrettank
boltx	bolt
boltz	bolt
gboltx	cannon
gboltz	cannon
zvfigh	wingman
zvhraz	wingman
zvtank	wingman
zvwalk	walker
dummy	camerapod
tvspec	wingman
bvartl01	howitzer
bvmuf101	recycler
bvmuf102	recycler
bvmuf103	recycler
bvmuf104	recycler
bvraz02	wingman
bvraz03	wingman
bvraz04	wingman
bvscav02	scavenger
bvscav03	scavenger
bvscav04	scavenger
bvturr03	turrettank
bvturr04	turrettank
bvwalk02	walker
bvwalk03	walker
bvwalk04	walker
sbtowe01	turret
svapc01	apc
svartl01	howitzer
svcnst01	constructionrig
svfigh01	wingman
svhraz01	wingman
svmuf102	factory
svmuf103	factory
svrckt01	wingman
svrecy01	recycler
svslf101	armory
gatkstab	cannon
gminisvk	machinegun
kbkhng	repairdepot
kbksup	supplydepot
kspilo	person
ksuser	person
kvkart	howitzer
kvkbom	wingman
kvkcns	constructionrig
kvkfig	wingman
kvklun	wingman
kvksca	scavenger
kvkslf	armory
kvktnk	wingman
kvktur	turrettank
kvrecy	recycler
sbkbar	barracks
sbkhng	repairdepot
sbksil	scrapsilo
sbksup	supplydepot
spkmin	wpnpower
svkart	howitzer
svkbom	wingman
svkcns	constructionrig
svkfig	wingman
svklun	wingman
svkrec	factory
svksca	scavenger
svkslf	armory
svktnk	wingman
svktug	tug
svktur	turrettank
asiani1	person
bsiani2	person
csiani2	person
ianhngi1	supplydepot
ianhngi2	repairdepot
ssiani2	person
assoldi1	person
assoldi2	person
avrecyin	recycler
ianurave	person
avmuf201	factory
avslf101	armory
cvfigh01	wingman
cvltnk01	wingman
cvmuf01	factory
cvrecy01	recycler
cvslf01	armory
cvtnk01	wingman
cbtowe01	turret
cvartl01	howitzer
cvrckt01	wingman
svltnk01	wingman
svslf01	armory
avlamp	wingman
avlamp01	sav
avslf01	armory
avtest01	turrettank
cbian01	turret
cbian02	turret
cbian03	i76building
cbian04	supplydepot
cbian05	repairdepot
cbian07	i76building2
cian01	recycler
cian03	factory
cian04	factory
cian05	factory
cian06	constructionrig
cian07	constructionrig
cian08	recycler
cian10	powerplant
cian11	apc
cian12	person
cian13	daywrecker
cian14	quakeblast
cian15	factory
cian16	artifact
csian01	person
csian02	person
csian03	person
csian04	person
eggian1	flare
eggian2	flamepuff
gcian01	dispenser
gcian02	cannon
gcian03	rocket
gcian04	dispenser
gcian06	grenade
gcian07	quakeblast
gcian08	seismic
gcian09	cannon
gcian10	rocket
hvcian09	wingman
ianuser2	person
avxtnk	wingman
svmuf01	factory
abbar1	barracks
abcom1	commtower
abhan1	repairdepot
absil1	scrapsilo
abspo1	powerplant
absup1	supplydepot
abtow1	turret
aspil6	person
avap1	apc
avap2	apc
avart1	howitzer
avcns1	constructionrig
avhra1	wingman
avltn1	wingman
avmu1	factory
avmuf02	factory
avrec1	recycler
avsca1	scavenger
avsl1	armory
avtan1	wingman
avtan2	wingman
avtur1	turrettank
avwal1	walker
avwalk02	walker
avwalk03	walker
bbbar2	barracks
eggeizr2	geyser
bsblc1	person
bvblc1	recycler
bvblc2	factory
bvblc3	armory
bvblc4	constructionrig
bvblc5	wingman
bvblc6	turrettank
proxblc1	proximity
sbblc1	turret
sbblc2	i76building
ssblc1	person
svblc1	apc
abian08	turret
cbian06	i76building
gcian05	spraybomb
iangrid	beamgun
iangrid1	beam
iangrid3	i76sign
sspilb	person
svhrbb	wingman
svreb1	recycler
svreb2	recycler
svreb3	recycler
svscab	scavenger
svtabb	wingman
svtubb	turrettank
svwab1	walker
svwab2	walker
svwab3	walker
cvhra3	wingman
cvltn1	wingman
cvtnk2	wingman
cvhtnk01	wingman
apgatt	wpnpower
appopsnp	wpnpower
aprifle	wpnpower
apshotgn	wpnpower
apsmine	wpnpower
apsnpbmb	wpnpower
avfighs	wingman
avtanks	wingman
gattler	snipershell
ggattler	snipergun
gminegun	snipergun
gpopsnip	poppergun
grifle	snipergun
gshotgun	snipergun
gsnipbmb	mortar
gsnipmin	dispenser
gsnprock	snipergun
minegun	snipershell
popsbul	snipershell
popsnipe	popper
rifle	snipershell
shotgun	snipershell
snipebm	spraybomb
snipebm2	spraybomb
snipmine	weaponmine
sniprock	snipershell
xpsnpcar	explosion
asiani2	person
bsiani3	person
gianwpn1	cannon
gianwpn2	tracer
gianwpn3	cannon
gianwpn4	rocket
gianwpn5	explosion
gianwpn6	machinegun
gianwpn7	tracer
gianwpn8	snipergun
gianwpn9	tracer
gianwpna	cannon
gianwpnb	rocket
gianwpnc	mortar
gianwpnd	grenade
gianwpne	shockblast
gianwpnf	cannon
gianwpng	bolt
bspilb	person
corain	tracer
cowave	spraybomb
coxplbld	explosion
coxplcar	explosion
coxplgnd	groundblast
dayw	proximity
daywind	seismic
kbport	i76building
xwindxpl	quakeblast
xwinxpl	shockblast
abbank	scrapsilo
abbarr2	barracks
abdebris	turret
ablpadde	camerapod
ablpadrb	i76building
ablpadre	i76building
abrecfa2	repairdepot
abrecfa3	supplydepot
abrecfac	repairdepot
abshldos	shieldtower
abtether	turret
abtowshl	turret
acceler	magnet
alarmin	proximity
apacce	wpnpower
apbg02	wpnpower
apbg03	wpnpower
apbltmno	wpnpower
apcamrcn	camerapod
apcamrhb	camerapod
apcbolt	wpnpower
apclwncr	wpnpower
apcricmp	wpnpower
apdetmnd	wpnpower
apdisrup	wpnpower
apdstrct	wpnpower
apfoun	wpnpower
apfrwrck	wpnpower
apilomin	weaponmine
apmgstab	wpnpower
apneed	wpnpower
appenetr	wpnpower
apphaser	wpnpower
apptorp	wpnpower
apsalv	wpnpower
apsingul	wpnpower
apsprite	wpnpower
apsstbdp	wpnpower
apsstbop	wpnpower
aptagmi	wpnpower
aptbolt	wpnpower
aptbolt2	wpnpower
aptether	wpnpower
apturb	wpnpower
apwrckde	daywrecker
apxcann	wpnpower
apxrflsh	wpnpower
asavcnst	person
asavfigh	person
asavrecy	person
asavtank	person
asbvfig2	person
asbvhra2	person
asbvltn2	person
asbvrck2	person
asbvrecy	person
asbvtan2	person
asbvtank	person
ascvfigh	person
ascvtnk	person
asfigdp2	person
ashradp2	person
asltndp2	person
asmser	person
asmsew	walker
aspjaild	person
aspjaile	sav
asprisnr	person
asraz20	person
asrckdp2	person
assnipr	person
assvfigh	person
assvtank	person
astan20	person
astandp2	person
astgpl03	person
astgpl06	person
astrigpl	person
asus50	person
avapcfke	apc
avapci	wingman
avapcwrk	apc
avbcex	wingman
avcnstl	constructionrig
avcnstlp	constructionrig
avcnstw	constructionrig
avdrmp	wingman
avdrone	wingman
avdslc	wingman
avdummy	wingman
avlcnst	constructionrig
avmads	factory
avmuf7	factory
avmuf9	factory
avmufi	factory
avmufo3	factory
avosmu1	factory
avosre1	recycler
avrec9	recycler
avreci	recycler
avrecyl	recycler
avrecylp	recycler
avrecyo3	recycler
avrecyo6	recycler
avrecyw	recycler
avslf7	armory
avtcnst	constructionrig
avtes7	turrettank
bbcom3	commtower
bbcommd2	commtower
bbhango1	repairdepot
bbhango2	repairdepot
bbsiloo1	scrapsilo
bbtoweo1	turret
blstg	bolt
blstg3	bolt
bltmino	weaponmine
bullet5p	tracer
bvapco2	apc
bvartlo1	howitzer
bvcnstia	constructionrig
bvcnstl	constructionrig
bvcnsts	constructionrig
bvcnstw	constructionrig
bvhrazo1	wingman
bvlcnst	constructionrig
bvmufia	factory
bvmufo1	factory
bvmufo3	factory
bvmufo4	factory
bvmufo6	factory
bvmufo7	factory
bvmufos	factory
bvrazo1	wingman
bvrecyia	recycler
bvrecyl	recycler
bvrecyo1	recycler
bvrecyo3	recycler
bvrecyo4	recycler
bvrecyo5	recycler
bvrecyo6	recycler
bvrecyo7	recycler
bvrecyo8	recycler
bvrecyol	recycler
bvrecyos	recycler
bvrecyow	recycler
bvrecyw	recycler
bvslfo1	armory
bvslfo3	armory
bvslfos	armory
bvtkrk	wingman
crickemp	tracer
cspusr	person
cvcnstl	constructionrig
cvcnstw	constructionrig
cvhowmuf	factory
cvlcnst	constructionrig
cvlrecy	recycler
cvmufd1	factory
cvmufwak	factory
cvmumo	factory
cvrecyd1	recycler
cvrecyl	recycler
cvrecyw	recycler
cvremo	recycler
cvslfd1	armory
cvwcnst	constructionrig
cvwmuf	factory
cvwrecy	recycler
dbbarr	barracks
dbcomm	commtower
dbhang	repairdepot
dblasr	turret
dbmbld	supplydepot
dbsilo	scrapsilo
dbtowe	turret
deselect	switcher
disrup	beam
dspilo	person
dssold	person
dstrct	bouncebomb
dsuser	person
dvapc	apc
dvartl	howitzer
dvcnst	constructionrig
dvcnstl	constructionrig
dvcnstw	constructionrig
dvfigh	wingman
dvhaul	tug
dvhraz	wingman
dvhtnk	wingman
dvltnk	wingman
dvmine	minelayer
dvmuf	factory
dvrckt	wingman
dvrecy	recycler
dvrecyl	recycler
dvrecyw	recycler
dvscav	scavenger
dvslf	armory
dvtnk	wingman
dvturr	turrettank
dvwalk	walker
exhaust	flamepuff
exstport	flare
fountain	flare
founted	rocket
founter	popper
gacceler	dispenser
gapilmin	dispenser
gapilo	dispenser
gassold	dispenser
gavcnst	dispenser
gavfigh	dispenser
gavfigh2	dispenser
gavhraz2	dispenser
gavltnk2	dispenser
gavrckt2	dispenser
gavrecy	dispenser
gavtank	dispenser
gavtank2	dispenser
gblstg	cannon
gblstg3	cannon
gbltmino	dispenser
gbvfigh2	dispenser
gbvhraz2	dispenser
gbvltnk2	dispenser
gbvraz20	dispenser
gbvrckt2	dispenser
gbvrecy	dispenser
gbvtan20	dispenser
gbvtank	dispenser
gbvtank2	dispenser
gclowncr	dispenser
gclowncs	dispenser
gcrickmp	cannon
gcvfigh	dispenser
gcvtnk	dispenser
gdaywrck	dispenser
gdeselec	cannon
gdetmnd	dispenser
gdisrup	beamgun
gdstrct	detonator
gfount	dispenser
ggtflash	beamgun
ghvsat15	dispenser
ghvsat2	dispenser
ghvsat5	dispenser
ghvsav15	dispenser
ghvsav2	dispenser
ghvsav5	dispenser
glflar	dispenser
gmdrkt1	cannon
gmgstab	cannon
gndgsnp	snipergun
gneedler	cannon
gpenetra	snipergun
gphaser	beamgun
gptorp	imagelauncher
grcktslv	chargegun
grwhb	cannon
grwmin	dispenser
grwstab	cannon
gshldmin	dispenser
gsingul	dispenser
gspilmin	dispenser
gspilo	dispenser
gsprtmin	dispenser
gsssold	dispenser
gsstbds	cannon
gsstbos	cannon
gstalkr	radarlauncher
gsupwrck	dispenser
gsvapca2	dispenser
gsvfig15	dispenser
gsvfigh	dispenser
gsvfigh2	dispenser
gsvfigh5	dispenser
gsvhra15	dispenser
gsvhraz2	dispenser
gsvhraz5	dispenser
gsvltn15	dispenser
gsvltnk2	dispenser
gsvltnk5	dispenser
gsvrck15	dispenser
gsvrckt2	dispenser
gsvrckt5	dispenser
gsvsav5	dispenser
gsvtan15	dispenser
gsvtank	dispenser
gsvtank2	dispenser
gsvtank5	dispenser
gtagmis	targeting
gtbolt	beamgun
gtbolt2	beamgun
gtether	cannon
gtflash	beam
gtminigp	machinegun
gtrigmin	machinegun
gturbols	cannon
gxcann	cannon
gxrflash	beamgun
hbhang	repairdepot
hbsupp	supplydepot
hbtoweo1	turret
hbturr	turret
hsdesele	person
hsdspnsr	turret
hsdsprcy	turret
hsmarn	person
hspilo	person
hssatd15	person
hssatdp2	person
hssatdp5	person
hssavd15	person
hssavdp2	person
hssavdp5	person
hssnpr	person
hvmuf	factory
hvturr	wingman
jailmin	magnet
lflar	flare
marstorm	magnet
mbbarr	barracks
mbcomm	commtower
mbhang	repairdepot
mbmbld	supplydepot
mbsilo	scrapsilo
mbsupp	supplydepot
mbtowe	turret
medrkt1	rocket
mgstab	anchor
msgmine	proximity
msoffi	person
mspilo	person
mspool	walker
mssold	person
msuser	person
mvapc	apc
mvartl	howitzer
mvcnst	constructionrig
mvcnstl	constructionrig
mvcnstw	constructionrig
mvhaul	tug
mvhraz	wingman
mvltnk	wingman
mvmine	minelayer
mvmuf	factory
mvpool	wingman
mvpool2	wingman
mvraz	wingman
mvrckt	wingman
mvrdev	wingman
mvrecy	recycler
mvrecyl	recycler
mvrecyw	recycler
mvscav	scavenger
mvslf	armory
mvtank	wingman
mvturr	turrettank
mvwalk	walker
ncapt	i76sign
needle	thermalmissile
obdetmin	weaponmine
pacer100	tug
pacer200	tug
penetrat	snipershell
perwrck	person
phaser	beam
proxperm	proximity
prsnbus	tug
ptorp	imagemissile
rbbarr	barracks
rbcafa	i76building
rbcafe	i76building
rbcomm	commtower
rbhang	repairdepot
rbhqcp	i76building
rblpad	i76building
rblpow	powerplant
rbmbld	supplydepot
rbshld	i76building
rbsilo	scrapsilo
rbspow	powerplant
rbsupp	supplydepot
rbtowe	turret
rbwpow	powerplant
rcktdsp	rocket
rcktosp	rocket
rcktslv	imagemissile
rsoffi	person
rspilo	person
rssnip	person
rssold	person
rsuser	person
rvapc	apc
rvartl	howitzer
rvcnst	constructionrig
rvcnstl	constructionrig
rvcnstw	constructionrig
rvfigh	wingman
rvfimp	wingman
rvfold	wingman
rvhaul	tug
rvhraz	wingman
rvhrmp	wingman
rvltmp	wingman
rvltnk	wingman
rvmine	minelayer
rvmuf	factory
rvrcmp	wingman
rvrecy	recycler
rvrecyl	recycler
rvrecyw	recycler
rvsav	wingman
rvscav	scavenger
rvslf	armory
rvtamp	wingman
rvtank	wingman
rvtold	wingman
rvturr	turrettank
rvwalk	walker
rvwamp	walker
rwblst	bolt
rwfigh	wingman
rwhraz	wingman
rwocket	rocket
rwrckt	wingman
rwtank	wingman
rwtank2	wingman
rwturr	turrettank
savtnk2	wingman
sbjail	i76building
sboshqcp	commtower
sbshldos	shieldtower
sbsingul	scrapsilo
sbtech	artifact
sbtecha	turret
sbtecha2	artifact
sbtechb	turret
sbtechb2	artifact
sbtechc	turret
sbtechc2	artifact
sbtowb	turret
sbtowshl	turret
sbtrgt	turret
shldpsh	magnet
singular	magnet
spclwncr	wpnpower
spilomin	weaponmine
spmrkt	wpnpower
sprter	popper
sprtmin	flare
sprtmsl	thermalmissile
sprwhb	wpnpower
sprwst	wpnpower
spstalk	wpnpower
ssapcai2	person
ssfigd15	person
ssfigdp2	person
ssfigdp5	person
sshrad15	person
sshradp2	person
sshradp5	person
ssltnd15	person
ssltndp2	person
ssltndp5	person
sspjaild	person
sspjaile	sav
ssprisnr	person
ssrckd15	person
ssrckdp2	person
ssrckdp5	person
sssavdp5	person
sssnipr	person
sstnkd15	person
sstnkdp2	person
sstnkdp5	person
stalkmsl	torpedo
supwrck	daywrecker
svapcai	wingman
svapcdst	apc
svartlp	howitzer
svcnsp	constructionrig
svcnstl	constructionrig
svcnstw	constructionrig
svdummy	turrettank
svffigh	wingman
svfhraz	wingman
svfigs	wingman
svfirp	wingman
svfltnk	wingman
svfmuf1	factory
svfmuf2	factory
svfrckt	wingman
svftank	wingman
svfturr	turrettank
svhaulp	tug
svhrazp	wingman
svltnkp	wingman
svminep	minelayer
svmufapc	factory
svmuff	factory
svmuffmp	factory
svmufldp	factory
svmufp	factory
svoffcr	wingman
svoscnsa	constructionrig
svosmufa	factory
svosreca	recycler
svosslfa	armory
svptfigh	wingman
svpthraz	wingman
svptltnk	wingman
svpttank	wingman
svrcktp	wingman
svrecapc	recycler
svrecotg	tug
svrecp	recycler
svrecyl	recycler
svrecyw	recycler
svrwfigh	wingman
svrwmuf	factory
svsavo1	sav
svsavo2	wingman
svsavo3	sav
svsavomp	wingman
svsavop2	wingman
svscrp	scavenger
svtankp	wingman
svtrgtr	turrettank
svturp	turrettank
tagmis	missile
tbolt	beam
tbolt2	beam
tether	switcher
turbols	tracer
wvraz	wingman
xalaxpl	planarexpl
xcann	tracer
xdisbld	explosion
xdiscar	explosion
xdisgnd	planarexpl
xmrtxpl	shockblast
xmsgxpl	planarexpl
xrflash	beam
xsprtfir	explosion
xstkxpl	shockblast
xsupbmb	quakeblast
xzapbld	explosion
xzapcar	explosion
xzapgnd	groundblast
cbtowez	turret
aplava	daywrecker
eggeizbr	geyser
eggeizfp	geyser
firequak	seismic
lavarock	grenade
apwind	daywrecker
bdogp	tracer
bvapc2	apc
bvhamp	tug
bvhaul2	tug
bvmine2	minelayer
bvrckt2	wingman
bvscav2	scavenger
bvtank2	wingman
bvtank3	wingman
bvwalk2	walker
ccar	tracer
cpwrck	daywrecker
crag	tracer
cvapc2	apc
cvfimp2	wingman
cvhamp	tug
cvhaul2	tug
cvhunt	wingman
cvmine2	minelayer
cvscav2	scavenger
gbdog	cannon
gcca	cannon
gcra	cannon
gcramin	dispenser
ghunter	imagerefract
probe	seismic
probeb2	spraybomb
probebm	spraybomb
proxmin2	proximity
svhamp	tug
tigarc0	cannon
tigarc1	rocket
tigarc2	popper
tigarc3	rocket
tigpro0	detonator
tigpro1	bouncebomb
tigpro2	popper
xcraxpl	quakeblast
xpro1xpl	shockblast
xproxpl	quakeblast
bbcc6a	supplydepot
bscc6a	person
bvcc6a	minelayer
bscc5a	person
bvcc5a	turrettank
bvcc5b	wingman
bvcc5c	wingman
avbbtk	wingman
avscbv	scavenger
bbbark	barracks
bbsils	scrapsilo
bspill	person
bspilt	person
bvartz	howitzer
bvrbz	wingman
bvrebz	recycler
bvrebz1	recycler
bvrebz2	recycler
bvrebz3	recycler
bvrebz4	recycler
bvrebz5	recycler
bvrebz6	recycler
bvtubz	turrettank
drone1	turrettank
drone2	turrettank
drone3	turrettank
drone4	turrettank
drone5	turrettank
drone6	turrettank
scav1	scavenger
scav2	scavenger
scav3	scavenger
scav4	scavenger
abwrk1	artifact
apwr01	daywrecker
bvwr01	recycler
bvwr02	factory
bvwr03	armory
bvwr04	constructionrig
bvwr05	turrettank
bvwr06	wingman
bvwr07	wingman
bvwr08	wingman
bvwr09	wingman
gmortwrk	mortar
gwrktow	machinegun
hbwr01	artifact
mortwrk	grenade
sswr01	person
svwr01	recycler
svwr02	factory
svwr03	scavenger
svwr04	turrettank
svwr05	wingman
svwr06	wingman
svwr07	wingman
svwr08	wingman
svwr09	wingman
svwr0a	turrettank
svwr0b	walker
svwr0c	wingman
svwr0d	armory
svwr0e	howitzer
svwr0f	apc
svwr0g	wingman
svwr0h	tug
svwr0i	tug
svwr10	walker
wrekmine	proximity
wrkbul7	tracer
xwrkxp1	quakeblast
abtowez	turrettank
anchor2	anchor
apanchor	wpnpower
apcamn	proximity
apcamv	turrettank
aphartlz	wpnpower
apnuke	wpnpower
apsstbz	wpnpower
aptank	wpnpower
apwasp	wpnpower
aspill	person
avapz1	wingman
avart2	howitzer
avcnst01	constructionrig
avfig1	wingman
avfig2	wingman
avfigh03	wingman
avhra2	wingman
avhraz03	wingman
avlamp2	wingman
avmuf203	factory
avrck2	wingman
avre01	recycler
avre02	recycler
avre03	recycler
avre04	recycler
avre11	recycler
avre12	recycler
avre13	recycler
avre14	recycler
avrecy03	recycler
avsca2	scavenger
avscav03	scavenger
avscavz	wingman
avscbw	scavenger
avslf103	armory
avta01	wingman
avtank03	wingman
avtank2	wingman
avtanv	wingman
avtu01	turrettank
avtu02	turrettank
avtur2	turrettank
avtur3	turrettank
avtur4	turrettank
avtur5	turrettank
avturr03	turrettank
avturr2	turrettank
avwa01	walker
avwa02	walker
avwa03	walker
avwa04	walker
avwal2	walker
avwal3	walker
avwal4	walker
bazooka	wingman
buzzsaw	wingman
bvstng	wingman
cvturr2	turrettank
fstealth	wingman
ganchor	cannon
ghartilz	mortar
ghornetz	thermallauncher
gnavdmin	dispenser
gnuke	cannon
gproxmi2	dispenser
grease	wingman
gspstabz	cannon
gtank	dispenser
heatmsl2	thermalmissile
heatmslz	thermalmissile
nuke	rocket
proxmin2	daywrecker
rockxl	walker
shelz	grenade
svhrazz	wingman
tweet	wingman
virus	wingman
xbmbxppl	quakeblast
xbmnuke	quakeblast
xpltrskz	quakeblast
sbbmpi	barracks
avsopro	wingman
sbpilots	barracks
sbspmsn	turret
avlof1	wingman
avlof2	tug
avlof3	apc
avlof4	recycler
avlof5	factory
avlof6	armory
avlof7	constructionrig
avlof8	wingman
glofstab	cannon
oblof1	i76building
proxlof1	proximity
sslof1	person
svlof1	howitzer
svlof2	wingman
svlof3	wingman
bbtowe1	turret
bbtowe2	turret
bvrdev01	wingman
aptmin	wpnpower
tminig	machinegun
aden	tracer
apaden	wpnpower
apsqln	wpnpower
apstub	wpnpower
gaden	cannon
gatstub	cannon
gsqlint	mortar
rucket	bullet
sqlintb2	sqraybomb
sqlintbm	spraybomb
sqlinter	tracer
uvfigh	wingman
uvltnk	wingman
uvmuf	constructionrig
uvrdev	wingman
uvtank	wingman
uvtest	turrettank
apbtowe1	daywrecker
apbtowe2	daywrecker
apbtowe3	daywrecker
apgtowe1	daywrecker
apgtowe2	daywrecker
apgtowe3	daywrecker
aphanger	daywrecker
apobjmrk	camerapod
aprtowe1	daywrecker
aprtowe2	daywrecker
aprtowe3	daywrecker
apshield	daywrecker
apsilol	daywrecker
apsilom	daywrecker
apsilos	daywrecker
apsupply	daywrecker
aptdtank	daywrecker
aptele	daywrecker
avtdslf	armory
cannonb	tracer
cannong	tracer
cannonp	tracer
fastcom	torpedo
firebeam	beam
g2xhorn	cannon
g3xshad	cannon
gcannb	cannon
gcanng	cannon
gcannp	cannon
gfastcom	radarlauncher
gfirebem	beamgun
gitblast	cannon
gskblast	cannon
heatshad	thermalmissile
itblast	bolt
shield	scrap
shkblast	bolt
svtdslf	armory
tbbtowe1	turret
tbbtowe2	turret
tbbtowe3	turret
tbgtowe1	turret
tbgtowe2	turret
tbgtowe3	turret
tbhang	repairdepot
tbrtowe1	turret
tbrtowe2	turret
tbrtowe3	turret
tbshield	i76building
tbsilol	scrapsilo
tbsilom	scrapsilo
tbsilos	scrapsilo
tbsupp	supplydepot
tbtdpow	powerplant
tbtele	i76building
tvapc	apc
tvapcb	apc
tvfigh	wingman
tvfigh2	wingman
tvhraz	wingman
tvhraz2	wingman
tvraid	wingman
tvrdev	wingman
tvsat	wingman
tvtank	wingman
tvtank2	wingman
tvwalk	walker
tvwalk2	walker
tvwalkb	walker
xdrkgnd	planarexpl
xplsgnd	planarexpl
xshckxpl	explosion
xshitxpl	explosion
xteleb	explosion
xtelep	explosion
xteler	explosion
apmagnet	wpnpower
apmbm	wpnpower
apmgun	wpnpower
aprepl	wpnpower
apsting	wpnpower
aptrch	wpnpower
aptrpdo	wpnpower
apzap	wpnpower
aspils	wingman
aspils2	wingman
aspils3	wingman
aspils4	wingman
avfig0	wingman
avltn2	wingman
avmufvm	factory
avrck9	wingman
avrecyvm	recycler
avslfvm	armory
avwal7	wingman
boltmin7	weaponmine
cvfigc	wingman
cvhtnv	wingman
gmagnet	dispenser
gmgun	cannon
gmitsbm	mortar
gpopz	poppergun
grepl	mortar
gsflare	dispenser
gspstabe	cannon
gtorch	beamgun
gtrpdo	radarlauncher
gzap	mortar
magnet	magnet
mitsbm	spraybomb
mitspay	spraybomb
mitspay	magnet
nparrvm	barracks
repell	spraybomb
repeller	spraybomb
repeller	magnet
rgun	bullet
rocket3e	rocket
rustank	wingman
sniper1	wingman
super2	wingman
switch2	switcher
switchv	cannon
torch	beam
torpedo1	torpedo
vflare	flare
virus2	wingman
virus3	wingman
zapper	spraybomb
avfighx9	wingman
avhrazx9	wingman
avltnkx9	wingman
avrcktx9	wingman
avrex901	recycler
avrex902	recycler
avrex903	recycler
avrex904	recycler
avscavx9	scavenger
avscx901	scavenger
avscx902	scavenger
avtankx9	wingman
avtux901	turrettank
avtux902	turrettank
avwalkx9	walker
avwax901	walker
avwax902	walker
avwax903	walker
avwax904	walker
cvwalkx9	walker
cvwax904	walker
bulletx	tracer
charg1x	tracer
charg2x	tracer
gchargex	chargegun
gdelete	terrainexpose
glblast	cannon
gminix	machinegun
gshadx	imagelauncher
imagex	imagemissile
lbbtowe	repairdepot
lbdtow	i76building
lbdtowe	i76building
lbjtowe	repairdepot
lblast	bolt
lbttowe	repairdepot
lbwtowe	repairdepot
lbxtowe	repairdepot
lvplayer	wingman
lvplayrt	wingman
lvsfigh	wingman
lvsfigh1	wingman
lvsltnk	wingman
lvsltnk1	wingman
lvsrckt	wingman
lvsrckt1	wingman
lvssav	sav
lvstank	wingman
lvstank1	wingman
lvsturr	turrettank
lvsturr1	turrettank
xtowewin	planarexpl
apnenv	camerapod
apwnav	wpnpower
bbne01	commtower
bbne02	barracks
bvne01	recycler
bvne02	factory
bvne03	armory
bvne04	turrettank
bvne05	wingman
bvne06	wingman
bvne07	wingman
bvne08	wingman
bvne09	walker
bvne0a	apc
bvne0c	constructionrig
bvne0d	wingman
gnenav	dispenser
obnems	i76building
proxne01	proximity
sbne01	turret
ssne01	person
ssne02	person
svne01	recycler
svne02	factory
svne03	scavenger
svne04	turrettank
svne05	wingman
svne06	wingman
svne07	wingman
svne08	wingman
svne09	walker
svne0a	howitzer
svne0b	constructionrig
svne0c	apc
svne0d	turrettank
hocrys	magnet
svhrbz	wingman
svmubz	factory
svrcbz	wingman
svrebz	recycler
svscbz	scavenger
svtbzs	wingman
svtubz	turrettank
svwabz	walker
cvsnipe	person
cvsold1	person
cvsold2	person
sbtow1	turret
svfig0	wingman
svhra3	wingman
svltn3	wingman
svmuz	factory
svrck3	wingman
svrck8	wingman
svrecz	recycler
svten3	wingman
svwal3	walker
svfch5	wingman
1bbarr	barracks
1bcomm	commtower
1bhang	repairdepot
1bsilo	scrapsilo
1bspow	powerplant
1bsupp	supplydepot
1btowe	turret
1spilo	person
1ssold	person
1suser	person
1vapc	apc
1vartl	howitzer
1vcnst	constructionrig
1vfigh	wingman
1vfimp	wingman
1vhraz	wingman
1vhrmp	wingman
1vltnk	wingman
1vmine	minelayer
1vmuf	factory
1vrckt	wingman
1vremp	recycler
1vscav	scavenger
1vslf	armory
1vtank	wingman
1vturr	turrettank
1vwalk	walker
2bbarr	barracks
2bcomm	commtower
2bhang	repairdepot
2bsilo	scrapsilo
2bspow	powerplant
2bsupp	supplydepot
2btowe	turret
2spilo	person
2ssold	person
2suser	person
2vapc	apc
2vartl	howitzer
2vcnst	constructionrig
2vfigh	wingman
2vfimp	wingman
2vhraz	wingman
2vhrmp	wingman
2vltnk	wingman
2vmine	minelayer
2vmuf	factory
2vrckt	wingman
2vremp	recycler
2vscav	scavenger
2vslf	armory
2vtank	wingman
2vturr	turrettank
2vwalk	walker
3bbarr	barracks
3bcomm	commtower
3bhang	repairdepot
3bsilo	scrapsilo
3bspow	powerplant
3bsupp	supplydepot
3btowe	turret
3spilo	person
3ssold	person
3suser	person
3vapc	apc
3vartl	howitzer
3vcnst	constructionrig
3vfigh	wingman
3vfimp	wingman
3vhraz	wingman
3vhrmp	wingman
3vltnk	wingman
3vmine	minelayer
3vmuf	factory
3vrckt	wingman
3vremp	recycler
3vscav	scavenger
3vslf	armory
3vtank	wingman
3vturr	turrettank
3vwalk	walker
sfield8	scrapfield
avrecci	recycler
avslfci	armory
bvmufci	factory
bvrecci	recycler
bvslfci	armory
bvtaci	wingman
cvrecci	recycler
cvslfci	armory
svrecci	recycler
svslfci	armory
bvrempnm	recycler
bvslfnm	armory
decoz	spraybomb
gsplice	mortar
splincep	wpnpower
cvwalk02	walker
cvcnst01	constructionrig
1vcnstl	constructionrig
1vcnstw	constructionrig
1vrempl	recycler
1vrempw	recycler
2vcnstl	constructionrig
2vcnstw	constructionrig
2vrempl	recycler
2vrempw	recycler
3vcnstl	constructionrig
3vcnstw	constructionrig
3vrempl	recycler
3vrempw	recycler
apcamc	camerapod
apmin1	wpnpower
apsstbp	wpnpower
bexmsnow	i76building2
bminxpl	explosion
bullet6b	tracer
bulletgr	tracer
bvcnstl	constructionrig
bvian01	wingman
bvrempl	recycler
cpmini	wpnpower
cvcnstl	constructionrig
cvrempl	recycler
cvtn2	wingman
fixaim	rocket
gblas1	cannon
gfixaim	cannon
gsniper	snipergun
gspstabp	cannon
gtminisb	machinegun
gvulcan	machinegun
obmbxpl	rocket
ominxpl	rocket
otorxpl	rocket
pbmbxpl	quakeblast
pminxpl	quakeblast
ptorxpl	quakeblast
rocket3x	rocket
spbls1	wpnpower
spmin1	wpnpower
xianmsl2	explosion
xianmsl3	planarexpl
xmslian1	explosion
xnulxpl	explosion
ianbox	recycler
ianbox2	factory
ianbox3	armory
ianboxer	person
iann6	camerapod
iann7	camerapod
iann8	camerapod
ianshang	repairdepot
ianshng2	supplydepot
ianssmin	proximity
ianstnk3	wingman
sbian01	commtower
wmsgian1	turrettank
wmsgian2	turrettank
wmsgian3	turrettank
wmsgian4	turrettank
wmsgian5	turrettank
wmsgian6	turrettank
wmsgian7	turrettank
wmsgian8	turrettank
wmsgian9	turrettank
wmsgiana	turrettank
wmsgianb	turrettank
wmsgianc	turrettank
wmsgiand	turrettank
rocket3z	rocket
abht01	powerplant
bvht01	recycler
bvht02	factory
bvht03	armory
bvht04	constructionrig
bvht05	turrettank
sbht05	repairdepot
sbht06	powerplant
sbht07	turret
ssht01	person
ssht02	person
ssht03	person
svht01	wingman
svht02	walker
svht03	wingman
abpha1a	repairdepot
abpha1b	supplydepot
asph1a	person
asph1b	person
avpha1a	turrettank
ssph1a	person
aspha201	person
avpha201	factory
avpha202	wingman
avpha203	turrettank
avpha204	constructionrig
avpha205	tug
gphas2rd	radardamper
gphas2vr	imagerefract
phas2msl	torpedo
sbpha201	repairdepot
sbpha202	turret
sspha201	person
svpha201	turrettank
svpha202	turrettank
svpha203	tug
svpha204	wingman
svpha205	scavenger
svpha206	wingman
appha301	ammopack
appha302	repairkit
avpha301	recycler
avpha302	turrettank
avpha303	wingman
avpha304	wingman
avpha305	wingman
pha3xpl1	quakeblast
sbpha301	turret
sppha301	daywrecker
sspha301	person
sspha302	person
svpha301	walker
svpha302	walker
svpha303	wingman
svpha304	wingman
bbitc1	commtower
bsbitc01	person
bvbitc01	turrettank
bvbitc02	wingman
bvbitc03	wingman
ssbitc01	person
ssbitc02	person
hbrcm01	i76building
hbrcm02	i76building
obrcm01	artifact
proxrcm1	proximity
svrcm01	walker
svrcm02	wingman
svrcm03	howitzer
svrcm04	tug
bvhrbk1	tug
hbhrbk1	artifact
sbhrbk1	commtower
sbhrbk2	commtower
sshrbk1	person
abm10a	commtower
abm10b	barracks
abm10c	i76building
abm10d	repairdepot
abm10e	repairdepot
asm10a	person
avm10a	turrettank
avm20a	turrettank
m2hraz	wingman
m2recy	recycler
avm31a	turrettank
m3apc	apc
m3muf	factory
m3recy	recycler
m3towe	turret
sbm31a	turret
svm31a	turrettank
obgatep	i76building
sbthoi1	turret
sbthoi2	powerplant
svthoi1	recycler
svthoi2	factory
svthoi3	wingman
svthoi4	turrettank
svthoi5	wingman
svthoi6	wingman
svthoi7	wingman
svthoi8	scavenger
svthoi9	wingman
svthoia	wingman
svthoib	wingman
svthoic	wingman
svthoid	wingman
abp101	repairdepot
abp102	supplydepot
asp101	person
sbp101	turret
ssp101	person
svp101	turrettank
svp102	wingman
svp103	wingman
svp104	wingman
svprt2a	howitzer
avpt31	recycler
avpt32	factory
avpt33	constructionrig
sbpt31	turret
appt41	camerapod
avpt41	recycler
avpt42	constructionrig
avpt43	turrettank
sbpt41	i76building
svpt41	tug
svpt42	tug
svpt43	tug
svpt44	tug
abp501	i76building
app5wk	daywrecker
avp501	recycler
avp502	factory
avp503	turrettank
bvp501	wingman
gp5burn	beamgun
p5burn	beam
p5expl	quakeblast
sbp501	turret
sbp502	i76building
svp501	turrettank
svp502	wingman
svp503	wingman
svp504	wingman
svp505	wingman
svp506	wingman
apopw01	daywrecker
avop01	recycler
avop02	factory
avop03	constructionrig
avop04	turrettank
avop05	armory
outpsxp1	quakeblast
abstor	artifact
abstora	artifact
abstorx	artifact
abtowexx	turret
apdropx	camerapod
apdropx2	camerapod
avscavx	scavenger
bvscavx	scavenger
cvscavx	scavenger
svscavx	scavenger
bvredf1	recycler
bvredf2	factory
bvredf3	armory
bvredf4	constructionrig
bvredf5	turrettank
bvredf6	wingman
bvredf7	wingman
grfh01	thermallauncher
grfld02	radardamper
hbredf1	i76building
obredf1	artifact
proxre01	proximity
sbredf1	turret
sbredf2	repairdepot
sbredf3	repairdepot
sbredf4	i76building
svredf1	recycler
svredf2	factory
svredf3	scavenger
svredf4	turrettank
svredf5	wingman
svredf6	wingman
svredf7	wingman
svredf8	turrettank
svredf9	wingman
svredfa	wingman
svredfb	wingman
svredfc	wingman
svredfd	turrettank
svredfe	turrettank
svredff	apc
svredfg	tug
avcf01	recycler
avcf02	factory
avcf03	turrettank
proxcf01	proximity
sbcf01	turret
sbcf02	commtower
sscf01	person
svcf01	walker
svcf02	apc
svcf03	wingman
svcf04	wingman
nblpow	powerplant
abffox1	repairdepot
apffox1	camerapod
apffxf	wpnpower
asffox1	person
avffox1	turrettank
avffox2	factory
avffox3	constructionrig
avffox4	turrettank
avffox5	wingman
avffox6	recycler
bsffox1	person
bvffox1	wingman
fxbeam1	beam
fxblast	bolt
fxflam	flamepuff
fxflash	beam
fxphan	imagerefract
fxpmine	proximity
fxshell	grenade
fxvulcan	flare
gfxartl	mortar
gfxblst	cannon
gfxflsh	beamgun
gfxggun	beamgun
obffox1	i76building
obffox2	i76building
sbffox1	turret
sbffox2	turret
sbffox3	powerplant
sbffox4	powerplant
sbffox5	i76building
sbffox6	i76building
svffox1	recycler
svffox2	factory
svffox3	scavenger
svffox4	turrettank
svffox5	wingman
svffox6	wingman
svffox7	wingman
svffox8	wingman
svffox9	howitzer
svffoxa	wingman
svffoxb	turrettank
svffoxc	howitzer
svffoxd	wingman
svffoxe	wingman
svffoxf	wingman
svffoxg	wingman
svffoxh	tug
svffoxi	recycler
gcloak	imagerefract
gcrasnp	snipergun
ggrenade	detonator
gpack	dispenser
grenade	bouncebomb
gsnip2	snipergun
guaaf	chargegun
guaaf1	flamepuff
guaaf2	flamepuff
guaaf3	flamepuff
kvwalk	walker
nspilo	person
nsuser	person
oc1user	person
oc2user	person
oc3user	person
oc4user	person
oc5user	person
oc6user	person
oc7user	wingman
oc8user	person
oc9user	person
ocbarr	barracks
ocbot1	scavenger
ocbot2	scavenger
ocstor	supplydepot
s3jet	magnet
s3jet2	magnet
s3pack	magnet
s3rld1	turrettank
s3rld2	turrettank
snip2	snipershell
ssprae	person
uvspec	wingman
xgregnd	explosion
xgrexpl	explosion
avin0001	hover
avin0002	hover
avin0003	turrettank
bullbdi1	tracer
bvfibdi1	wingman
bvfibdi2	wingman
bvhtnki1	wingman
bvmufbi1	factory
gbdian01	machinegun
gianshad	imagelauncher
gbhide	radardamper
scrporeb	artifact
scrporep	artifact
scrposib	turret
scrposip	turret
abcmin01	i76building
abhnin01	repairdepot
abin0001	turret
abin0002	shieldtower
abin0003	i76building
abin0004	i76building
abin0005	turret
ablpin01	i76building
abrein01	i76building
abrein02	walker
abrein03	i76building
abrein04	i76building
abrein05	weaponmine
abrein06	artifact
abrein07	artifact
abrein08	i76building
abrktow	turret
abshin01	i76building
abspin01	supplydepot
ammobm	spraybomb
ammobm	ammopack
apcamin1	camerapod
apflam	wpnpower
aplase	wpnpower
appumm	wpnpower
apquil	wpnpower
avcnin01	constructionrig
avhtnk	wingman
avin0004	wingman
avin0005	wingman
avin0006	hover
avin0007	apc
avmru	minelayer
avrein01	recycler
bazook1	rocket
bazooka	rocket
bbhnin01	repairdepot
bbin0001	commtower
bbspin01	supplydepot
bsnmin01	person
bsnmin02	person
bsnmin03	person
bvhtnk	wingman
bvin0001	wingman
bvin0002	wingman
bvin0003	wingman
bvin0004	wingman
bvin0005	wingman
bvin0006	walker
bvin0007	constructionrig
bvin0008	constructionrig
bvin0009	constructionrig
bvin0010	sav
bvin0011	constructionrig
bvin0012	wingman
bvin0013	constructionrig
bvin0015	turrettank
bvin0016	turrettank
bvin0017	wingman
bvincns1	constructionrig
bvinmuf	factory
bvinmuf2	factory
bvinmuf3	factory
bvinmuf4	factory
bvinrec	recycler
bvinrec2	recycler
bvinrec3	recycler
bvinrec4	recycler
bvinslf	armory
bvnightg	minelayer
cbin0001	i76building
cbshut	powerplant
chaingun	tracer
csin0001	person
evcarr0a	wingman
evcarr0s	wingman
evcarr1s	sav
evcnst1s	constructionrig
evfigh0a	wingman
evfigh0s	wingman
evhraz0a	wingman
evhraz0s	wingman
evhraz1a	wingman
evhtnk0a	wingman
evhtnk0s	wingman
fbpilo	person
fsian01	person
fsian02	person
fvbap	apc
fvcnsta	constructionrig
fvdron	wingman
fvgech	walker
fvgriz	wingman
fvhtnk	wingman
fvin0001	wingman
fvin0002	wingman
fvin0003	wingman
fvin0004	walker
fvin0005	wingman
fvin0006	recycler
fvin0007	factory
fvin0008	wingman
fvrckt	wingman
fvrecya	recycler
fvtank	wingman
gbdian02	cannon
gbdian03	tracer
gbdian04	dispenser
gbdian05	spraybomb
gbdian06	grenade
gbdian07	quakeblast
gbdian08	dispenser
gbdian09	magnet
gbdian10	cannon
gbdian11	thermalmissile
gbdian12	dispenser
gbdian13	spraybomb
gbdian14	flamepuff
gbdian15	explosion
gbdian16	cannon
gbdian17	thermalmissile
gbdian18	cannon
gbdian19	rocket
gbdian20	cannon
gbdian21	rocket
gbdian22	cannon
gbdian23	bolt
gbdian24	spraybomb
gbdian25	spraybomb
gbdian25	ammopack
gbdian26	ammopack
gbdian27	spraybomb
gbdian27	repairkit
gbdian28	spraybomb
gbdian29	dispenser
gbdian30	snipergun
gbdian31	snipershell
gbdian32	wpnpower
gbdian33	cannon
gbdian34	tracer
gbdian35	cannon
gbdian36	bolt
gbdian37	radardamper
gbdian38	cannon
gbdian39	rocket
gbdian40	machinegun
gbdian41	tracer
gbdian42	mortar
gbdian43	cannon
gbdian44	rocket
gbdian45	cannon
gbdian46	bolt
gbdian47	cannon
gbdian48	rocket
gbdian49	dispenser
gbdian50	weaponmine
gbdian51	cannon
gbdian52	rocket
gbdian53	cannon
gbdian54	rocket
gchain	machinegun
gianhavc	cannon
glaser	cannon
gpian01	wpnpower
gpian02	wpnpower
gpian03	wpnpower
gpian04	wpnpower
gpian05	wpnpower
gpian06	wpnpower
gpian07	wpnpower
gpian08	wpnpower
gpian09	wpnpower
gpian10	wpnpower
gpummel	cannon
gquill	cannon
gsalvo	cannon
havcian	anchor
hvian01	walker
hvian02	wingman
hvian03	wingman
hvian04	wingman
hvrazc	wingman
hvreb	wingman
hvreb	shockblast
hvspod	i76building
hvwalk	walker
ianexpl	explosion
ibin0001	turret
ibrkt	turret
iorock01	portal
iorock02	portal
iorock03	portal
iorock04	portal
iorock05	portal
iorock06	portal
ipulse	cannon
irifle	tracer
isian01	person
isian02	person
isian03	person
issold	person
isuser	person
ivapc	apc
ivbike	wingman
ivdshp	apc
ivhraz	wingman
ivhtnk	wingman
ivin0001	wingman
ivin0002	wingman
ivin0003	turrettank
ivin0004	apc
ivin0005	wingman
ivin0006	wingman
ivin0007	walker
ivin0008	scavenger
ivin0009	sav
ivin0010	wingman
ivinslf	armory
ivmru	minelayer
ivrtnk	wingman
ivsabr	wingman
ivscav	scavenger
ivserv	minelayer
ivtank	wingman
ivturr	turrettank
ivwalk	walker
laser	bolt
pulsebld	explosion
pulsecar	explosion
pulsegnd	groundblast
pummel	bullet
quill	bullet
salvo	bullet
sbcomp	i76building
sbin0001	powerplant
sbin0002	supplydepot
sbin0003	supplydepot
sbin0004	i76building
sbin0005	supplydepot
sbin0006	i76building
sbin0007	i76building
sbin0008	artifact
sbin0009	scrapsilo
sbin0010	i76building
sbomni	powerplant
sbpost	supplydepot
sbstor	supplydepot
sbwal2	i76building
sbwall	supplydepot
ssian001	person
svbian01	wingman
svbian02	wingman
svbian03	walker
svbian04	wingman
svbian05	wingman
svbian06	wingman
svbian07	wingman
svbian08	turrettank
svbian09	factory
svbian10	walker
svbian11	apc
svbian12	hover
svbian13	wingman
svbian14	recycler
svhtnk	wingman
svutil	minelayer
uvhcra	wingman
xchnbld	explosion
xchncar	explosion
xchngnd	groundblast
xflmthrg	quakeblast
xmslian2	explosion
xsalvobd	explosion
xsalvocr	explosion
xsalvogd	explosion
cbsilb	scrapsilo
cvartz	howitzer
cvfigt	wingman
cvrebz	recycler
cvsca1	scavenger
nparr	supplydepot
ammod	spraybomb
ap2atst	wpnpower
ap2blst	wpnpower
ap2chan	wpnpower
ap2fafm	wpnpower
ap2flsh	wpnpower
ap2hell	wpnpower
ap2mini	wpnpower
ap2mort	wpnpower
ap2plas	wpnpower
ap2puls	wpnpower
ap2pumm	wpnpower
ap2shad	wpnpower
ap2smor	wpnpower
ap2spst	wpnpower
ap2tag	wpnpower
apcmort	wpnpower
apdrone	wpnpower
aplaunch	wpnpower
atstab_c	bullet
bbant	i76building
blast_a	bolt
cdrone	wingman
chain_c	bullet
concmort	grenade
flash_a	rocket
flmgnd	flamepuff
flmthr	grenade
g2jetpak	dispenser
g2mini	machinegun
g2mortar	mortar
g2shad	imagelauncher
g2smor	mortar
g2snipb	snipershell
g2snipe	snipergun
g2spst	cannon
g2tag	targeting
gammod	dispenser
gatstb1	cannon
gblast_a	cannon
gchain_c	machinegun
gcmort	mortar
gdayw	torpedo
gdrone	dispenser
gflash_a	cannon
gflmthr	mortar
ghell	poppergun
gianbaz	cannon
glaunch	mortar
gplasma	cannon
gplas_a	cannon
gplstab	cannon
gpulse	machinegun
grepad	dispenser
hellfire	popper
hellfmsl	thermalmissile
ibbarr	barracks
ibcomm	commtower
ibcrate	i76sign
ibgtow	turret
iblpad	i76building
ibpowe	powerplant
ibrel2	artifact
ibsbay	repairdepot
ibsilo	scrapsilo
ibsupp	supplydepot
ibtele	i76building
ibtunnel	i76building
ibtunsq	i76building
ibwall	i76sign
ibwallc	i76sign
ibwrgt	i76building
ibwtow	i76building
ipammo	ammopack
ipnav	camerapod
iprepa	repairkit
irelic	artifact
ispilo	person
ivatank	wingman
ivbomb	apc
ivcarr	i76building
ivcnst	constructionrig
ivdrone	hover
ivdrop	turret
ivfac	factory
ivhscav	scavenger
ivltnk	wingman
ivmbike	wingman
ivmisl	wingman
ivmuf	factory
ivrckt	wingman
ivrecold	recycler
ivrecy	recycler
ivrocket	wingman
ivscout	wingman
ivslf	armory
ivstas	wingman
ivtug	tug
ivursa	wingman
jetpack	magnet
launch	spraybomb
leader_c	leader
mini2	bullet
mortar_c	grenade
pbcry1	i76sign
pbcry2	i76sign
pbhall	i76building
plasma_a	bullet
plasma_c	bullet
plstab	rocket
pummel	tracer
repabomb	spraybomb
repabomb	repairkit
repad	spraybomb
rock1	i76sign
shadow2	imagemissile
spst	bullet
tracer	bullet
urchin	i76sign
xblstbld	explosion
xblstcar	explosion
xblstgnd	explosion
xbulgnd	explosion
xchngnd	explosion
xconcb	quakeblast
xdaywxp	quakeblast
xfafgnd	explosion
xfafmsl	explosion
xflabld	explosion
xflacar	explosion
xflagnd	explosion
xhell	explosion
xhellf	explosion
xleadbld	explosion
xleadcar	explosion
xmortgnd	explosion
xmortxpl	explosion
xmslgnd	explosion
xplasbld	explosion
xplascar	explosion
xplasgnd	explosion
xpulgnd	explosion
xpulhit	explosion
xspcar	explosion
xspgnd	explosion
xstabcar	explosion
xstabgnd	explosion
xtagbld	explosion
xtagcar	explosion
xtaggnd	explosion
zvrdev	wingman
zvtnk	wingman
avtrum	wingman
gtrumdm	mortar
gtrumin	machinegun
gtrurkt	cannon
gtrustb	cannon
trustab	rocket
bbcal01	repairdepot
bbcal02	supplydepot
bbcal03	repairdepot
bvcal01	factory
bvcal02	constructionrig
bvcal03	scavenger
bvcal04	wingman
bvcal05	turrettank
bvcal06	wingman
bvcal07	walker
bvcal08	armory
hbcal01	artifact
sbcal01	repairdepot
sbcal02	repairdepot
sbcal03	i76building
sbcal04	i76building
sbcal05	turret
svcal01	turrettank
svcal02	turrettank
svcal03	wingman
svcal04	wingman
svcal05	walker
abarc01	artifact
avarc01	recycler
avarc02	factory
avarc03	armory
avarc04	turrettank
obarc01	artifact
sbarc01	commtower
sbarc02	turret
svarc01	turrettank
svarc02	wingman
svarc03	wingman
svarc04	wingman
svarc05	wingman
svarc06	apc
ahardpta	i76building2
ahardptb	i76building2
ahardptc	i76building2
ahardpts	i76building2
armoryui	i76building2
armpanel	i76building2
armunibv	i76building2
armunicv	i76building2
armunisv	i76building2
armunits	i76building2
avcank	wingman
avcaz	wingman
avccav	scavenger
avcckt	wingman
avcigh	wingman
avcine	minelayer
avcraz	wingman
bridgea	i76building2
bridgeb	i76building2
bridgec	i76building2
bridgec2	i76building2
bridged	i76building2
bridgee	i76building2
bullet7	tracer
bullet7a	rocket
bvcank	wingman
bvcaz	wingman
bvccav	scavenger
bvcckt	wingman
bvcdev	wingman
bvcine	minelayer
bvcnstw	constructionrig
bvcraz	wingman
bvctnk	wingman
bvrempw	recycler
cavceila	i76building2
comrelya	turret
comrelyb	turret
comrelyc	turret
comrelyd	turret
cvcalk	walker
cvccav	scavenger
cvcckt	wingman
cvcigh	wingman
cvcine	minelayer
cvcnk	wingman
cvcnstw	constructionrig
cvcraz	wingman
cvctnk	wingman
cvrempw	recycler
gcraturr	cannon
gfixai2	cannon
gfixaitu	cannon
gminigrn	cannon
gtminig	cannon
gtminis	cannon
gtminisb	cannon
pointl_b	flare
pointl_b	rocket
pointl_d	flare
pointl_d	rocket
pointl_g	flare
pointl_g	rocket
pointl_p	flare
pointl_p	rocket
pointl_r	flare
pointl_r	rocket
pointl_t	flare
pointl_t	rocket
pointl_w	flare
pointl_w	rocket
pointl_y	flare
pointl_y	rocket
scrporeg	turret
scrporep	turret
scrporer	turret
scrporey	turret
svcank	wingman
svccav	scavenger
svcckt	wingman
svcigh	wingman
svcine	minelayer
svctnk	wingman
tltunnel	i76building2
toraenv	i76building2
trtunnel	i76building2
qbcomm	commtower
qbhang	repairdepot
qbsupp	supplydepot
qbtowe	turret
qolt	bolt
qssold	person
qvartl	howitzer
qvcnst	constructionrig
qvcnstl	constructionrig
qvian01	wingman
qvltnk	wingman
qvmine	minelayer
qvmuf	factory
qvraz	wingman
qvrckt	wingman
qvrdev	wingman
qvremp	recycler
qvrempl	recycler
qvrempnm	recycler
qvrmpa	wingman
qvrmpb	wingman
qvscav	scavenger
qvslf	armory
qvslfnm	armory
qvtank	wingman
qvturr	turrettank
qvwalk	walker
abbrck02	grenade
abcmck02	grenade
abgtck01	spraybomb
abgtck02	grenade
abgtck02	spraybomb
abgtck03	grenade
abgtck03	spraybomb
abhnck02	grenade
abhqck02	grenade
abllck01	spraybomb
ablpck01	spraybomb
abmbck01	spraybomb
absick01	spraybomb
abspck01	spraybomb
abstck01	grenade
absuck01	spraybomb
abwpck01	grenade
avapck01	spraybomb
avapck02	spraybomb
avapcspl	spraybomb
avarck01	spraybomb
avartlsp	spraybomb
avbmck01	spraybomb
avbmck02	grenade
avcnck01	spraybomb
avcnck02	grenade
avcnstsp	spraybomb
avfighsp	spraybomb
avhwck01	spraybomb
avhwck02	grenade
avltck01	spraybomb
avmfck01	spraybomb
avmfck02	grenade
avmnck01	spraybomb
avreck01	spraybomb
avrkck01	spraybomb
avrzck01	spraybomb
avrzck02	grenade
avscck01	spraybomb
avtack01	grenade
avtack02	spraybomb
avtack03	grenade
avtgck01	spraybomb
avtnksp	spraybomb
avtrck01	spraybomb
avwkck01	spraybomb
bbbrck02	grenade
bbcmdish	grenade
bbcmtent	grenade
bbhnck02	grenade
bbhqcpck	grenade
bbllck01	spraybomb
bblpck01	spraybomb
bvapck01	spraybomb
bvapck02	spraybomb
bvapcspl	spraybomb
bvarck01	spraybomb
bvbmck01	spraybomb
bvbmck02	grenade
bvchnk01	grenade
bvcnck01	spraybomb
bvcnck02	grenade
bvcnstsp	spraybomb
bvltck01	spraybomb
bvmfck01	spraybomb
bvmnck01	spraybomb
bvrdck01	spraybomb
bvreck01	spraybomb
bvrkck01	spraybomb
bvrzck01	spraybomb
bvrzck02	grenade
bvscck01	spraybomb
bvtack02	spraybomb
bvtack03	grenade
bvtgck01	spraybomb
bvwkck01	spraybomb
cbbkck01	grenade
cbcmck01	grenade
cbgtck01	spraybomb
cbhgck01	grenade
cbllck01	grenade
cblpck01	grenade
cblrck01	spraybomb
cbpock01	grenade
cbsick01	grenade
cbspck01	grenade
cbsuck01	grenade
cvamck01	spraybomb
cvapck01	spraybomb
cvapck02	grenade
cvarck01	spraybomb
cvarck02	grenade
cvbits	grenade
cvbmck01	spraybomb
cvcock01	spraybomb
cvfick01	spraybomb
cvfick02	grenade
cvhtck01	spraybomb
cvhtck02	grenade
cvltck01	spraybomb
cvltck02	grenade
cvmfck01	spraybomb
cvmnck01	spraybomb
cvrcck01	spraybomb
cvreck01	spraybomb
cvreck02	grenade
cvreck03	grenade
cvscck01	spraybomb
cvtkck01	spraybomb
cvtrck01	spraybomb
cvtuck01	spraybomb
gib	grenade
hvchnk01	spraybomb
sbbrck01	spraybomb
sbgtck01	spraybomb
sbhnck01	spraybomb
sbhqck01	spraybomb
sbllck01	spraybomb
sblpck01	spraybomb
sbmbck01	spraybomb
sbsick01	spraybomb
sbwpck01	grenade
svamck01	spraybomb
svapck01	spraybomb
svapck02	spraybomb
svapcspl	spraybomb
svarck01	spraybomb
svbmck01	spraybomb
svbmck02	grenade
svcnck01	spraybomb
svfick01	spraybomb
svfick02	grenade
svfick03	spraybomb
svfuck01	spraybomb
svltck01	spraybomb
svmfck01	spraybomb
svmfck02	grenade
svmnck01	spraybomb
svmnck02	grenade
svrcck01	spraybomb
svrcck02	grenade
svrcck03	grenade
svrkck01	spraybomb
svscck01	spraybomb
svtack01	spraybomb
svtack02	spraybomb
svtack03	grenade
svtack04	grenade
svtack05	grenade
svtgck01	spraybomb
svtnksp2	spraybomb
svtnkspl	spraybomb
svtrck01	spraybomb
svwkck01	spraybomb
xabbarc	spraybomb
xabbarr	quakeblast
xabbarsp	spraybomb
xabcomc	spraybomb
xabcomm	quakeblast
xabcomsp	spraybomb
xabgtow2	quakeblast
xabgtow3	quakeblast
xabhanc	spraybomb
xabhang	quakeblast
xabhans	spraybomb
xabhqcc	spraybomb
xabhqcp	quakeblast
xabhqcs	spraybomb
xabitspl	spraybomb
xablpad	quakeblast
xablpad2	grenade
xablpad2	spraybomb
xablpads	spraybomb
xablpow	quakeblast
xablpow2	grenade
xablpow2	spraybomb
xablpows	spraybomb
xabmbld	quakeblast
xabmbld2	grenade
xabmbld2	spraybomb
xabmblds	spraybomb
xabsilo	quakeblast
xabsilo2	grenade
xabsilo2	spraybomb
xabsilos	spraybomb
xabspow	quakeblast
xabspow2	grenade
xabspow2	spraybomb
xabspows	spraybomb
xabstor	quakeblast
xabstor2	grenade
xabstor2	spraybomb
xabstors	spraybomb
xabsupp	quakeblast
xabsupp2	grenade
xabsupp2	spraybomb
xabsupps	spraybomb
xabtowe	quakeblast
xabwpow	quakeblast
xabwpowc	spraybomb
xabwpows	spraybomb
xaspilo	quakeblast
xaspilog	spraybomb
xavapca	quakeblast
xavapcq1	quakeblast
xavartla	quakeblast
xavartlq	quakeblast
xavcnst	quakeblast
xavcnstc	quakeblast
xavfigh	quakeblast
xavfighc	quakeblast
xavhaul	quakeblast
xavhraz	quakeblast
xavhrazc	quakeblast
xavhw01	quakeblast
xavltnk	quakeblast
xavmine	quakeblast
xavmuf	quakeblast
xavmufc	quakeblast
xavrckt	quakeblast
xavrecy	quakeblast
xavscav	quakeblast
xavslf	quakeblast
xavtanka	quakeblast
xavtnkq2	quakeblast
xavtnkqs	quakeblast
xavturr	quakeblast
xavwalk	quakeblast
xbbbarc	spraybomb
xbbbarr	quakeblast
xbbbarsp	spraybomb
xbbcomm	quakeblast
xbbcommc	spraybomb
xbbcomms	spraybomb
xbbhanc	spraybomb
xbbhang	quakeblast
xbbhans	spraybomb
xbbhqcp	quakeblast
xbbhqcpc	spraybomb
xbbhqcps	spraybomb
xbblpad	quakeblast
xbblpad2	grenade
xbblpad2	spraybomb
xbblpads	spraybomb
xbblpow	quakeblast
xbblpow2	grenade
xbblpow2	spraybomb
xbblpows	spraybomb
xbbtent	quakeblast
xbbtentc	spraybomb
xbbtents	spraybomb
xbigchnk	quakeblast
xbldgch	spraybomb
xbldspl	spraybomb
xbldspr	explosion
xbldxpla	quakeblast
xbloodsp	spraybomb
xbvapc	quakeblast
xbvapcq1	quakeblast
xbvbits	quakeblast
xbvchnk	quakeblast
xbvcnst	quakeblast
xbvcnstc	quakeblast
xbvfigh	quakeblast
xbvfighc	quakeblast
xbvhaul	quakeblast
xbvhraz	quakeblast
xbvhrazc	quakeblast
xbvltnk	quakeblast
xbvmine	quakeblast
xbvmuf	quakeblast
xbvrckt	quakeblast
xbvrdev	quakeblast
xbvrecy	quakeblast
xbvscav	quakeblast
xbvslf	quakeblast
xbvtanka	quakeblast
xbvwalk	quakeblast
xcarxpla	quakeblast
xcarxplb	quakeblast
xcbbarr	quakeblast
xcbbarrc	spraybomb
xcbbarrs	spraybomb
xcbchnk	quakeblast
xcbcomm	quakeblast
xcbcommc	spraybomb
xcbcomms	spraybomb
xcbhang	quakeblast
xcbhangc	spraybomb
xcbhangs	spraybomb
xcblasr	quakeblast
xcblpad	quakeblast
xcblpadc	spraybomb
xcblpads	spraybomb
xcblpow	quakeblast
xcblpowc	spraybomb
xcblpows	spraybomb
xcbport	quakeblast
xcbportc	spraybomb
xcbports	spraybomb
xcbsilo	quakeblast
xcbsiloc	spraybomb
xcbsilos	spraybomb
xcbspow	quakeblast
xcbspowc	spraybomb
xcbspows	spraybomb
xcbsupp	quakeblast
xcbsuppc	spraybomb
xcbsupps	spraybomb
xcbtowe	quakeblast
xchunk1	spraybomb
xchunk2	grenade
xchunk3	grenade
xchunk4	grenade
xchunk5	grenade
xchunkbr	quakeblast
xchunkcm	quakeblast
xchunkhg	quakeblast
xchunkhn	quakeblast
xchunkhq	quakeblast
xchunkq	quakeblast
xchunkq1	quakeblast
xchunkq2	quakeblast
xchunkq3	quakeblast
xcvapc	quakeblast
xcvapc2	quakeblast
xcvartl	quakeblast
xcvartl2	quakeblast
xcvbits	quakeblast
xcvcnst	quakeblast
xcvfigh	quakeblast
xcvfigh2	quakeblast
xcvhaul	quakeblast
xcvhraz	quakeblast
xcvhtnk	quakeblast
xcvhtnk2	quakeblast
xcvltnk	quakeblast
xcvltnk2	quakeblast
xcvmine	quakeblast
xcvmuf	quakeblast
xcvrckt	quakeblast
xcvrecbt	quakeblast
xcvrecy	quakeblast
xcvrecy2	quakeblast
xcvscav	quakeblast
xcvslf	quakeblast
xcvtnk	quakeblast
xcvturr	quakeblast
xflaspl	spraybomb
xgib1	quakeblast
xgib2	spraybomb
xgibb	quakeblast
xgibc	grenade
xgibchk	quakeblast
xgiblet	quakeblast
xgibs	quakeblast
xgibspl	spraybomb
xgibz	spraybomb
xgndshk	quakeblast
xhvfury	quakeblast
xplsnipe	quakeblast
xsbbarr	quakeblast
xsbchnk	quakeblast
xsbchnkc	spraybomb
xsbchnks	spraybomb
xsbhang	quakeblast
xsbhqcp	quakeblast
xsblpad	quakeblast
xsblpow	quakeblast
xsbmbld	quakeblast
xsbsilo	quakeblast
xsbtowe	quakeblast
xsbwpow	quakeblast
xsbwpow2	quakeblast
xsbwpowc	spraybomb
xsbwpows	spraybomb
xsnipe	grenade
xsspilo	quakeblast
xsspilog	spraybomb
xsvapca	quakeblast
xsvapcq1	quakeblast
xsvartl	quakeblast
xsvcnst	quakeblast
xsvfigh	quakeblast
xsvfigha	quakeblast
xsvfiq1	quakeblast
xsvhaul	quakeblast
xsvhraz	quakeblast
xsvhraz2	quakeblast
xsvltnk	quakeblast
xsvmine	quakeblast
xsvmine2	quakeblast
xsvmuf	quakeblast
xsvmuf2	quakeblast
xsvrckt	quakeblast
xsvrecy	quakeblast
xsvrecy2	quakeblast
xsvrecy3	quakeblast
xsvsav	quakeblast
xsvscav	quakeblast
xsvslf	quakeblast
xsvtanka	quakeblast
xsvtnkq1	quakeblast
xsvtnkq2	quakeblast
xsvtnkq3	quakeblast
xsvtnkq4	quakeblast
xsvtnkqs	quakeblast
xsvturr	quakeblast
xsvwalk	quakeblast
ap2arcc	wpnpower
ap2bazo	powerup
ap2blstc	wpnpower
ap2bolt	wpnpower
ap2boost	wpnpower
ap2c4	wpnpower
ap2chan	powerup
ap2chant	wpnpower
ap2cover	wpnpower
ap2flam	wpnpower
ap2flar	wpnpower
ap2flars	wpnpower
ap2gasb	wpnpower
ap2gauss	wpnpower
ap2gspla	wpnpower
ap2guard	wpnpower
ap2horn	wpnpower
ap2howi	wpnpower
ap2ionga	wpnpower
ap2iongc	wpnpower
ap2jetp	powerup
ap2lock	wpnpower
ap2magg	wpnpower
ap2mcom	wpnpower
ap2mdmg	wpnpower
ap2mini	powerup
ap2mits	wpnpower
ap2multi	wpnpower
ap2plasg	wpnpower
ap2prox	wpnpower
ap2pumm	powerup
ap2purs	wpnpower
ap2quake	wpnpower
ap2quil	wpnpower
ap2quilc	wpnpower
ap2resin	wpnpower
ap2rock	wpnpower
ap2satc	wpnpower
ap2seek	wpnpower
ap2shild	wpnpower
ap2soni	wpnpower
ap2sonip	wpnpower
ap2splin	wpnpower
ap2sting	wpnpower
aplase	powerup
arcbolt	bullet
arcboltf	bullet
arcboltg	bullet
arccf	bolt
atlas	wingman
atstab_c	rocket
banebld1	i76building2
banebld2	i76building2
banebld3	i76building2
banebld4	i76building2
banedes4	i76building2
banedes5	i76building2
baneice1	i76building2
baneice2	i76building2
baneice3	i76building2
baneice4	i76building2
baneice5	i76building2
banerun1	i76building2
banerun2	i76building2
banesubw	i76building2
bazoo2	thermalmissile
bazoo3	imagemissile
bazooka	bullet
blast_c	bolt
blnktrgr	powerup
boltc	beam
boltr	beam
boost	flare
boost2	spraybomb
booster	anchor
bullet7	bullet
chunksp	spraybomb
comet_c	torpedo
cycl	bolt
cycl2	bolt
darkice1	i76building2
darkice2	i76building2
darkice3	i76building2
darkice4	i76building2
darkrun1	i76building2
darkrun2	i76building2
darkrun3	i76building2
darkrun4	i76building2
darkrun5	i76building2
darkrun6	i76building2
daywa	grenade
disrupt	spraybomb
disrupt2	spraybomb
disrupt3	anchor
dpilo1	i76sign
dpilo2	i76sign
dpilo3	i76sign
elect	bolt
eyeball	i76building2
fafmsl_a	thermalmissile
fbboltmn	weaponmine
fbcomm	commtower
fbgtow	turret
fbhang	repairdepot
fbjamm	scrapsilo
fbmisl	artifact
fbpowe	powerplant
fbproxmn	proximity
fbsilo	scrapsilo
fbsupp	supplydepot
fgsnip_c	machinegun
fhellfir	popper
flame	rocket
flame2	rocket
flare_s	bullet
flarmine	flare
flarmins	flare
flarpuff	bullet
flmgnd2	flamepuff
fsnip_c	bullet
fvapc	apc
fvbike	wingman
fvbrawl	wingman
fvdevil	wingman
fvdrone	wingman
fvdrop	turrettank
fvhlance	wingman
fvhscout	wingman
fvhsent	wingman
fvlance	wingman
fvlanced	wingman
fvmauler	walker
fvmufd	factory
fvrecy2	recycler
fvrecyb	recycler
fvrecyd	recycler
fvscout	wingman
fvscoutd	wingman
fvsentry	wingman
fvserv	minelayer
fvtank01	wingman
fvtankd	wingman
fvtankp	wingman
fvtankp1	wingman
fvtitan	wingman
fvtitanp	wingman
fvtug	tug
fvturr	turrettank
g2cover	cannon
g2gren	grenade
g2minia	machinegun
g2quake	cannon
g2recl	machinegun
g2rocket	cannon
g2sgren	mortar
g2voym	machinegun
garccf	cannon
garc_a	mortar
garc_c	cannon
garc_f	cannon
garc_gt	cannon
gasbomb	spraybomb
gasbomb2	flare
gauss_c	bolt
gblast_c	cannon
gblink	dispenser
gbltdrop	dispenser
gboltmin	cannon
gbolt_c	beamgun
gbolt_r	beamgun
gboost	dispenser
gbspstb	cannon
gc4	detonator
gchain_g	machinegun
gcharge	cannon
gcomet_c	radarlauncher
gcycl	cannon
gcycl2	cannon
gdaywa	mortar
gdisrupt	mortar
geplume	flare
geyspool	geyser
gfhell	poppergun
gfire	flare
gflamera	machinegun
gflares	dispenser
ggasmort	mortar
ggauss_c	cannon
ggplume	flare
gguard	cannon
ghealbm	beamgun
ghealtr	dispenser
ghell	cannon
ghell2	mortar
ghflash	beamgun
ghorni	thermallauncher
ghplume	flare
gianba2	snipergun
gianba3	imagelauncher
ginfect	mortar
giongn_a	machinegun
giongn_c	machinegun
giongn_f	machinegun
giplume	geyser
glaser_a	cannon
glock_c	cannon
glock_f	cannon
gmaggi	chargegun
gmeteor	mortar
gmitsfir	dispenser
gmlock_c	cannon
gmteorl	mortar
godrone	dispenser
godrone2	dispenser
godrone3	dispenser
gospray	cannon
gparadox	cannon
gplasfa	cannon
gplasgt	cannon
gplasgt2	imagelauncher
gplasgtl	cannon
gplasgtr	cannon
gplume	flare
gproxs	dispenser
gpulsef	machinegun
gquakmin	flare
gquill_a	cannon
gquill_c	cannon
grain	mortar
grayfog	flamepuff
greenfog	flamepuff
gresin	mortar
gsartill	mortar
gsatche2	detonator
gsatchel	dispenser
gshield	dispenser
gshield2	dispenser
gshotgun	cannon
gsluggun	snipergun
gsonicf	dispenser
gsonicp	dispenser
gsonic_c	cannon
gsoul	cannon
gsplasma	cannon
gsplasms	machinegun
gsprayg	cannon
gsting_a	cannon
gsting_c	cannon
gstrike	mortar
gtank2	dispenser
gtimest	cannon
gwasp2	dispenser
gzbite	cannon
gzdayb	daywrecker
gzdayw	dispenser
gzplume	flare
gzrckt	cannon
gzsold	dispenser
gzstab	cannon
hbcore	i76building
hblern01	i76building
hblern02	i76building
hblern03	i76building
hdrone	hover
hdrone2	hover
healbeam	beam
healtrgr	magnet
hellbomb	spraybomb
hellmisl	spraybomb
hflash	beam
hotblast	bullet
hvcmet	wingman
hvdayw	howitzer
hvguard	turrettank
hvguard2	turrettank
hvinfect	wingman
hvmisl	wingman
hvmort	wingman
hvpop	wingman
hvra2	wingman
hvraz	wingman
hvsat01	wingman
hvsav01	sav
hvscout	wingman
hvspod	walker
hvtank	wingman
hvxsat	wingman
ibbomb	i76building
ibbrid01	i76building
ibcmd	commtower
ibcmmd	commtower
ibcrate1	i76sign
ibcrate2	i76sign
ibdrop	i76building
ibdrop2	i76building
ibflag	i76sign
iblight1	i76sign
iblighta	i76sign
iblightc	i76sign
ibmuf	hover
ibrecy	hover
ibslf	hover
ibspotli	i76building
ibtele	portal
ibtunn01	i76building2
icover	seismic
ifencec	i76sign
ifences	i76sign
iflume	flamepuff
infect	spraybomb
infect2	spraybomb
infect3	switcher
ionize_a	bullet
ionize_c	bullet
ionize_f	bullet
ipnava	camerapod
ipserv	powerup
irocket2	rocket
isbazk	person
isbazk2	person
isdfmin1	person
isdfpilo	person
isdoom	person
iseismi	seismic
isharris	person
ispiloh	person
issant14	person
isuser	person
isuser2	person
isuser3	person
isusers	person
isuserw	person
ivapc2	tug
ivapc3	tug
ivatank2	wingman
ivatank3	wingman
ivbomb2	apc
ivcnst1	constructionrig
ivdapc	i76sign
ivdmisl	i76sign
ivdrop	turrettank
ivdrop2	turrettank
ivdropa	apc
ivdropan	turrettank
ivdropb	sav
ivdropc	turrettank
ivdropcr	i76building2
ivdropd	turrettank
ivdropp1	repairdepot
ivdropp2	repairdepot
ivdropt	tug
ivdtank	i76sign
ivhscou2	wingman
ivhscout	wingman
ivltnk2	wingman
ivmbike2	wingman
ivmisl2	wingman
ivmislau	i76building
ivmislo	wingman
ivmislo2	wingman
ivmissla	wingman
ivmuf1	factory
ivmuf2	factory
ivmuf3	factory
ivmuf4	factory
ivmufa	factory
ivmufd	factory
ivmufr	factory
ivradio	tug
ivrecy1	recycler
ivrecy2	recycler
ivrecy3	recycler
ivrecya	recycler
ivrecyd	recycler
ivrecyo	recycler
ivrecyr	recycler
ivrecyw	i76building
ivrecyz	recycler
ivsabr2	wingman
ivsabr3	wingman
ivsabrd	wingman
ivsabrd2	wingman
ivsabro	wingman
ivsabro2	wingman
ivsabrr	wingman
ivscouo2	wingman
ivscout2	wingman
ivscoutd	wingman
ivscouto	wingman
ivserv	tug
ivslf2	armory
ivspotli	hover
ivstas2	wingman
ivtest	turrettank
ivtest2	hover
ivturro	turrettank
ivturro2	turrettank
ivursa2	wingman
ivursa3	wingman
ivvoy00	wingman
jakskel	person
kronos	wingman
lasera	bolt
laser_c	bolt
lavagnd	quakeblast
lavamin2	spraybomb
lavamine	spraybomb
lavaspe2	spraybomb
lavaspew	grenade
locdownf	anchor
lockdown	anchor
locker	popper
lockerm	thermalmissile
mbolti	bullet
mbush01	i76building2
mcharge1	bullet
mcharge2	bullet
mcharge3	bullet
mcharge4	bullet
mcharge5	bullet
mcharge6	bullet
mdmgun	bouncebomb
meteorb1	spraybomb
meteorb2	spraybomb
meteorb3	spraybomb
meteorba	spraybomb
meteorbb	spraybomb
meteorbc	spraybomb
meteorbd	rocket
mini3	bullet
mini4	bullet
mirebrdg	i76building2
mirefire	i76sign
miregeys	geyser
mirehut	i76building2
mirerck1	i76building2
mirerck2	i76building2
mirerck3	i76building2
mirerun1	i76building2
mirerun2	i76building2
mirerun3	i76building2
mirerun4	i76building2
mireshr1	i76building2
mireshr2	i76building2
miretre1	i76building2
miretre2	i76building2
miretre3	i76building2
miretre4	i76building2
mirewal1	i76building2
mirewal2	i76building2
mirewal3	i76building2
mitsmine	weaponmine
mitsobjt	magnet
mortar_a	grenade
obbldg1	i76building
obbldg2	i76building
obbldg3	i76building
obturr	turrettank
obturr2	turrettank
obwall	i76sign
ospray	tracer
ovfigh	hover
ovfigh2	hover
ovgunsh2	sav
ovgunshp	sav
ovturr	turrettank
ovwall	turrettank
ovwall2	turrettank
paradox	bullet
pbcry1	i76building
pbcry3	i76sign
pbcry4	i76sign
pbcry5	i76sign
pflume	flamepuff
pgflume	flamepuff
plasball	bullet
plasma_f	imagemissile
plasma_g	thermalmissile
plasma_i	imagemissile
plasma_l	bullet
plasma_r	bullet
plasstrm	bullet
plstab	popper
plstabfa	popper
plume	flamepuff
plutobay	i76building
plutobed	i76building2
plutobn1	i76building2
plutobn2	i76building2
plutobn3	i76building2
plutobn4	i76building2
plutoclf	i76building2
plutocom	i76building
plutogar	i76building
plutohal	i76building2
plutohn2	i76building2
plutohng	i76building2
plutore1	artifact
plutore2	artifact
plutork1	i76sign
plutork2	i76sign
plutoscv	i76building2
plutotn1	i76building2
plutotun	i76building2
prop	i76building2
propb	i76building2
propd	i76building2
propp	i76building2
propr	i76building2
quakemin	seismic
quill_a	bullet
quill_c	bullet
rain	grenade
rain2	grenade
rain3	grenade
rain4	grenade
rainbox	i76building2
rainbox2	powerplant
rainbox3	powerplant
rainmin2	spraybomb
rainmin3	spraybomb
rainmin4	spraybomb
rainmine	spraybomb
raintest	i76building2
recluse	bullet
redfog	flamepuff
rendbol1	i76building2
rendbol2	i76building2
rendbol3	i76building2
rendbol4	i76building2
rendbol5	i76building2
rendgeys	geyser
rendrck1	i76building2
rendrck2	i76building2
rendrck3	i76building2
rendrck4	i76building2
rendrck5	i76building2
rendrck6	i76building2
rendrun1	portal
rendrun2	i76building2
rendrun3	i76building2
rendrun4	i76building2
rendrun5	i76building2
rendrun6	i76building2
rendrun7	i76building2
rendworm	person
resin	grenade
rock1	i76building2
rock2	i76building2
satbomb	bouncebomb
satch01	grenade
satchel	spraybomb
satchel2	bouncebomb
scionade	grenade
seekmine	torpedo
shield1	dropoff
shield2	dropoff
shotgun	thermalmissile
sign01	i76sign
sluggun	thermalmissile
sonicbls	anchor
sonicf	magnet
sonicp	magnet
soulsuck	rocket
splinter	bullet
spstab_c	rocket
sshell	grenade
stinger	thermalmissile
stingera	thermalmissile
striker	spraybomb
striker2	spraybomb
styxb1	i76building
styxb2	i76building
tartar1	i76building
tartar2	i76building
timestab	anchor
upforce	ammopack
uvturr	turrettank
waspmslf	torpedo
xarccar	explosion
xarcgnd	explosion
xatlcar	explosion
xbazgndc	explosion
xbazxplc	explosion
xbldxpl	quakeblast
xblinkin	explosion
xblinkot	explosion
xbmbxpl	explosion
xboom	explosion
xboots_e	planarexpl
xboots_n	planarexpl
xboots_s	planarexpl
xboots_w	planarexpl
xcarxpl	quakeblast
xchnki	grenade
xchunks1	quakeblast
xchunks2	grenade
xcomxpl	shockblast
xdaywxp	explosion
xflarhit	explosion
xflmfak	quakeblast
xflmhit	quakeblast
xfsnipca	explosion
xfsnipgn	explosion
xgasmxpl	explosion
xgaussbl	explosion
xgaussca	explosion
xgaussgn	explosion
xgrayfog	quakeblast
xgreengn	explosion
xgreenxp	explosion
xgrenfog	quakeblast
xhandcar	explosion
xhandgnd	explosion
xhealin	explosion
xioncar	explosion
xiongnd	explosion
xisdf1	quakeblast
xisdfc	spraybomb
xisdfspl	spraybomb
xlasebld	explosion
xlasecar	explosion
xlasegnd	explosion
xlava	quakeblast
xlavadr	explosion
xlavag	grenade
xlavas	spraybomb
xlckcar	explosion
xlckgnd	explosion
xlgtb	explosion
xlgtc	explosion
xlgtg	explosion
xlightb	explosion
xlightm1	explosion
xlightm2	explosion
xlightm3	explosion
xlightm4	explosion
xlightn	explosion
xlightn2	explosion
xlightn3	explosion
xlightn4	explosion
xlightp	explosion
xlightpn	explosion
xlightt	explosion
xlightt2	explosion
xlightt3	explosion
xlightt4	explosion
xlightv1	explosion
xlightv2	explosion
xlightv3	explosion
xlightv4	explosion
xlockdon	explosion
xlockgnd	explosion
xmagcar2	explosion
xmagcar3	explosion
xmagcar4	explosion
xmagcar5	explosion
xmagcar6	explosion
xmaggnd1	explosion
xmaggnd2	explosion
xmaggnd3	explosion
xmaggnd4	explosion
xmaggnd5	explosion
xmaggnd6	explosion
xmcomc	explosion
xmcomg	explosion
xmdmxpl	explosion
xminxpl2	explosion
xmorph	explosion
xparadox	explosion
xplblank	explosion
xplhad1	explosion
xpllava	quakeblast
xpllava2	explosion
xpllava3	quakeblast
xplnxpl	explosion
xplzom	quakeblast
xplzom2	flamepuff
xplzom3	quakeblast
xplzom4	explosion
xplzom5	explosion
xpuddle	planarexpl
xpulprox	explosion
xquillb	explosion
xquillc	explosion
xquillg	explosion
xrad	flamepuff
xradi	quakeblast
xrain	explosion
xraindr	planarexpl
xraindr2	explosion
xraindr3	explosion
xraindr4	explosion
xrainsp	explosion
xrecgnd	flamepuff
xrecluse	quakeblast
xredfog	quakeblast
xresgnd	explosion
xreshit	explosion
xrockxpl	explosion
xsatxpl	explosion
xscinspl	spraybomb
xscion	quakeblast
xscionc	spraybomb
xsecxpl	quakeblast
xseekxpl	explosion
xsflarht	explosion
xshotgn	explosion
xsnow	explosion
xsonicca	explosion
xsonicgn	explosion
xsplascr	explosion
xsplasgn	explosion
xsplchnk	spraybomb
xstingca	explosion
xstinggd	explosion
xvsat	wingman
xvsav1	walker
xvsav2	walker
xvsav3	walker
xwaterf	explosion
xyelfog	quakeblast
xzombb	quakeblast
xzombx	quakeblast
yelowfog	flamepuff
zflmgnd	flamepuff
zombbite	anchor
zombcann	anchor
zombmisl	thermalmissile
zspilo	person
zspilo2	person
zspilo3	person
zssold	walker
zvapc	wingman
zvapc2	wingman
zvrckt	wingman
zvwalk	person
zvwalk1	walker
avturrtd	turrettank
bvturrtd	turrettank
cvturrtd	turrettank
magpusht	magnet
svturrtd	turrettank
10mm	bullet
10plsrg	bullet
10plsrp	popper
10xplsr	quakeblast
10xplsre	quakeblast
10xplsrf	quakeblast
11plsrg	bullet
11plsrp	popper
11xplsr	quakeblast
11xplsre	quakeblast
11xplsrf	quakeblast
12plsrg	bullet
12plsrp	popper
12xplsr	quakeblast
12xplsre	quakeblast
12xplsrf	explosion
1ghfire	cannon
1hfire	rocket
1plsr	bullet
1xhfire	quakeblast
1xplsre	quakeblast
2hfire	rocket
2plsr	bullet
2xhfire	quakeblast
2xplsre	quakeblast
3hfire	rocket
3plsrg	bullet
3plsrp	popper
3xhfire	quakeblast
3xplsr	quakeblast
3xplsre	quakeblast
3xplsrf	quakeblast
4hfire	rocket
4plsrg	bullet
4plsrp	popper
4xhfire	quakeblast
4xplsr	quakeblast
4xplsre	quakeblast
4xplsrf	quakeblast
5hfire	popper
5plsrg	bullet
5plsrp	popper
5xhfire	explosion
5xplsr	quakeblast
5xplsre	quakeblast
5xplsrf	quakeblast
6hfire	rocket
6plsrg	bullet
6plsrp	popper
6xplsr	quakeblast
6xplsre	quakeblast
6xplsrf	quakeblast
7plsrg	bullet
7plsrp	popper
7xplsr	quakeblast
7xplsre	quakeblast
7xplsrf	quakeblast
8plsrg	bullet
8plsrp	popper
8xplsr	quakeblast
8xplsre	quakeblast
8xplsrf	quakeblast
9plsrg	bullet
9plsrp	popper
9xplsr	quakeblast
9xplsre	quakeblast
9xplsrf	quakeblast
ap2airb	wpnpower
ap2arcm	wpnpower
ap2bazof	wpnpower
ap2blink	wpnpower
ap2buff	wpnpower
ap2burst	powerup
ap2chanf	wpnpower
ap2chanv	wpnpower
ap2comb	wpnpower
ap2cphl	wpnpower
ap2dbomb	wpnpower
ap2drag	wpnpower
ap2fbaz	powerup
ap2fbgun	wpnpower
ap2fmor	wpnpower
ap2focus	wpnpower
ap2fount	wpnpower
ap2gausf	wpnpower
ap2gauss	powerup
ap2gren	powerup
ap2grenf	wpnpower
ap2hfire	wpnpower
ap2ionf2	wpnpower
ap2ionga	powerup
ap2iongc	powerup
ap2iongf	wpnpower
ap2jetpf	wpnpower
ap2lock	powerup
ap2lockf	wpnpower
ap2lrok	wpnpower
ap2minif	wpnpower
ap2mloc	wpnpower
ap2morti	wpnpower
ap2part	powerup
ap2pball	wpnpower
ap2popg	wpnpower
ap2porc	wpnpower
ap2pultr	wpnpower
ap2pummf	wpnpower
ap2pummv	wpnpower
ap2rave	wpnpower
ap2recl	powerup
ap2shel	powerup
ap2shot	powerup
ap2shotf	wpnpower
ap2slag	wpnpower
ap2slice	powerup
ap2splas	wpnpower
ap2spri	wpnpower
ap2sprox	wpnpower
ap2stnga	wpnpower
ap2turr	wpnpower
ap2wasp	wpnpower
ap2worm	wpnpower
ap2zomb	wpnpower
apdroneo	wpnpower
aphfire	wpnpower
aplasef	wpnpower
aplasev	wpnpower
arb	grenade
arcbltmp	bullet
archerms	thermalmissile
arcrok	thermalmissile
arcstop	anchor
atmin	proximity
autocann	bullet
avcnsti	constructionrig
banetram	i76building
banewrm1	person
banewrm2	person
bbbox	artifact
bbcomm03	i76building
bbconsol	i76building2
bbhang03	i76building
bbrecy03	i76building
bbsupp03	i76building
bbtent	barracks
bbtowe03	i76building
bdspil1	scrap
bdspil2	scrap
beamblue	beam
bflash	beam
bkrain2	grenade
blnktrgr	magnet
blood	grenade
boltr2	beam
bplascar	explosion
bplasgnd	explosion
bplas_a	beam
bvbtow	turrettank
bvbtow2	turrettank
bvdrone	hover
bvdrone2	hover
bvharpy	hover
bvhover	hover
bvtank03	i76building
b_xnukegnd_b	explosion
campfire	i76building2
cbtowe01	i76building2
cbtowe02	i76building2
cbtowe03	i76building2
cbtowe04	i76building2
cbtowe05	i76building2
cbtowe06	i76building2
cbtowe07	i76building2
cbturr	turrettank
cbturr2	turrettank
chain_a	bullet
chunk1	torpedo
chunk2	torpedo
coil_a	bolt
coreblst	bolt
corecomp	i76building
cpcruise	missile
cphcg_c	bullet
cphlas_c	bullet
cpserv	powerup
cpworm_c	thermalmissile
cturora	bolt
cturord	bolt
cvdrone	wingman
cvdtank	wingman
cvtruck	wingman
dabomb	spraybomb
dabombp	grenade
ddflya-3	thermalmissile
ddflyc-3	thermalmissile
debris	i76building2
demoion	bullet
demomini	bullet
demostab	bullet
deworm	i76building
dragb_c	bullet
duneplm1	i76building2
duneplm2	i76building2
dunewat	i76building2
ebbarr	barracks
ebcbun	commtower
ebgtow	turret
ebpowe	powerplant
ebsbay	repairdepot
ebsilo	scrapsilo
eburst_c	bullet
egsnip_c	machinegun
energ_a	bullet
epulse	bullet
epwrck	daywrecker
espilo	person
esuser	person
evartl	howitzer
evatank	wingman
evcnst	constructionrig
evkami	wingman
evmisl	wingman
evmort	wingman
evmuf	factory
evrecy	recycler
evscav	scavenger
evscout	wingman
evserv	tug
evslf	armory
evtank	wingman
evturr	turrettank
evwalk	walker
exshot	bullet
fafmsl_c	thermalmissile
fball1a	weaponmine
fball2a	thermalmissile
fbazok_a	bullet
fbazooka	bullet
fbazooka_c	bullet
fbgun_c	rocket
fbjamr	i76building2
fbport	portal
fgbzka_a	cannon
fgbzka_c	cannon
flamer	rocket
flameth	grenade
flamshot	bullet
flmgnd3	flamepuff
flmgnd4	flamepuff
flmgnd5	popper
fripr_c	bullet
fspilo2	person
fssnip	person
fssold2	person
fsuser	person
fvconsi	constructionrig
fvltank	wingman
fvmufc	factory
fvrecyc	recycler
fvremp2	recycler
fvscoutm	wingman
fvscoutv	wingman
fvsentd	wingman
fvserv	tug
fvstalk	wingman
fvstalk2	wingman
fvstalk3	wingman
g10mm	cannon
g2artl	mortar
g2esnip	snipergun
g2gren	mortar
g2grenf	mortar
g2guide	targeting
g2hovjet	dispenser
g2jetf	dispenser
g2minif	machinegun
g2morti	mortar
g2porc	targeting
g2smg	machinegun
g2torp	radarlauncher
g2wasp	imagelauncher
garb	mortar
garcherm	cannon
garcmin	dispenser
garc_mp	cannon
gatmin	dispenser
gauto	cannon
gautotr	dispenser
gbflash	beamgun
gbkrain2	mortar
gblah	camerapod
gblood	mortar
gboltbls	cannon
gboltblu	beamgun
gboltfm	dispenser
gbplas_a	cannon
gbuff	specialitem
gcblast	cannon
gchain_a	machinegun
gchain_f	machinegun
gcoil_a	cannon
gcombo1	cannon
gcoretr2	cannon
gcoretur	cannon
gcphcg_c	machinegun
gcphlas	cannon
gcpworm	cannon
gdabomb	dispenser
gddfly	cannon
gddflya-2	cannon
gddflyc-2	cannon
gdemoat	cannon
gdemoin	cannon
gdemomn	cannon
gdeton	dispenser
gdragb_c	cannon
gdroneo	dispenser
geburst	cannon
generg_a	machinegun
gexshot	cannon
gfball2	cannon
gfbgun	cannon
gfheal	beamgun
gflammin	dispenser
gflarei	dispenser
gflare_s	dispenser
gflmthr	machinegun
gfountn	dispenser
gfpopgn	cannon
gfripr_c	machinegun
ggaussf	cannon
ghail	mortar
gharris	cannon
gheal	dispenser
ghealhd	beamgun
ghestab	cannon
ghfire	mortar
ghmortar	mortar
ghydra	mortar
gianbzf	cannon
gionfak2	machinegun
gionfake	machinegun
giongnco	machinegun
glaserf	cannon
glaserrk	cannon
glazer	cannon
glockf	cannon
glshotf	cannon
glshotg	cannon
gmdmmor	detonator
gmfocus	machinegun
gmirvbm	detonator
gmitsdrp	dispenser
gmlock_c	chargegun
gplasbal	cannon
gplasgtm	cannon
gplastab	cannon
gpoptag	mortar
gproxi	dispenser
gpulsar	cannon
gpummef	cannon
grenxpl	grenade
gscorpc	cannon
gscorpg	machinegun
gsentry	machinegun
gshelgun	machinegun
gslagstb	cannon
gslicer	beamgun
gsnare	dispenser
gsnarem	cannon
gsold	dispenser
gspike	dispenser
gsplinti	mortar
gsprink	cannon
gstalk	machinegun
gstalk2	cannon
gstalk3	cannon
gtagcr	targeting
gtrumin	cannon
gturbo	dispenser
hailbolt	bolt
hailshot	popper
hail_c	grenade
hbtranny	i76building
healbemf	beam
healbmha	beam
hestab_a	bullet
hfire	spraybomb
hfire2	flare
hlaunch	spraybomb
hmortar	grenade
hydra	popper
hydra_c	grenade
ib2barr	i76building
ibautotr	weaponmine
ibbarro	barracks
ibbomb	barracks
ibbombo	barracks
ibbridan	animbuilding
ibbridia	i76building2
ibcommo	commtower
ibfrig00	artifact
ibgtowm	turret
ibgtowo	turret
ibpowef	powerplant
ibpoweo	powerplant
ibsbayo	repairdepot
ibscrap	artifact
ibteleo	portal
ice	i76building2
ionizeco	bullet
ipserv	repairkit
isbazko	person
isharr2	person
ispiloo	person
issmg	person
isusertx	person
ivangel	wingman
ivapc	howitzer
ivapcc	howitzer
ivapco	howitzer
ivartl	howitzer
ivasub	wingman
ivatankd	wingman
ivatanko	wingman
ivbdhsco	wingman
ivbombo	apc
ivbsub	wingman
ivcnst2	recycler
ivcnstd	constructionrig
ivcnsti	constructionrig
ivcnstia	constructionrig
ivcnsto	constructionrig
ivcons	constructionrig
ivcrick	wingman
ivdrone2	hover
ivdroneo	hover
ivfightr	wingman
ivfrig00	wingman
ivfrig01	recycler
ivgdhsco	wingman
ivhrazo	wingman
ivinterc	wingman
ivltnko	wingman
ivmbikeo	wingman
ivmine	minelayer
ivmine2	minelayer
ivmine3	minelayer
ivmine3o	minelayer
ivmini1	turret
ivmini2	turret
ivmislo3	wingman
ivmufb	factory
ivmufia	factory
ivmufo	factory
ivmufoia	factory
ivrcktd	wingman
ivrckto	wingman
ivrecia	recycler
ivrecstc	recycler
ivrecyia	recycler
ivremp	recycler
ivrover	wingman
ivscoutv	wingman
ivscouv2	wingman
ivslfo	armory
ivstaso	wingman
ivwalkd	walker
ivwalko	walker
jak	person
jbbarr	barracks
jbcomm	commtower
jbhang	repairdepot
jbpowe	powerplant
jbtowe	turret
jetpak2	magnet
jspilo	person
jvapc	apc
jvartl	howitzer
jvatnk	wingman
jvcnst	constructionrig
jvdron	hover
jvhscout	wingman
jvhtnk	wingman
jvmbik	wingman
jvrckt	wingman
jvrecy	recycler
jvscav	scavenger
jvscout	wingman
jvserv	scavenger
jvtank	wingman
jvtrmine	turret
jvturr	turrettank
laserg	missile
laserrok	thermalmissile
lavaflam	flamepuff
lazer	bolt
mercrok1	i76building2
mercrok2	i76building2
mercrok3	i76building2
mercrok4	i76building2
mercrok5	i76building2
mercrok6	i76building2
mfocus	bolt
mirvbm	bouncebomb
mirvfrag	grenade
mortar_h	grenade
mortar_i	grenade
mvremp	recycler
mvscout	wingman
obbuld01	i76building2
obbuld02	i76building2
obpipe01	i76building2
obpipe02	i76building2
obtowe01	i76building2
pballarc	bullet
pballfir	popper
plasbalc	popper
plasbalg	anchor
plasma_g	popper
plasma_m	bullet
plastab	bullet
playheal	magnet
plsrfire	bullet
poprocf	bullet
popshell	popper
poptag	popper
poptagrk	thermalmissile
poptgx	thermalmissile
porcupin	missile
propc	i76building2
propt	i76building2
proxmini	proximity
quakdrop	quakeblast
rapdmini	bullet
scorpc	bullet
scorpg	bullet
sentgun	bullet
shelgun	bullet
shotgunl	bullet
shothar	thermalmissile
slagstab	bullet
slicer_c	beam
smg	tracer
snare	anchor
snarmine	weaponmine
spikemin	torpedo
splintbi	spraybomb
splinti	bullet
splinti2	spraybomb
splinti3	bullet
sprink_c	thermalmissile
stalk	bullet
swarmb2	missile
techno	bullet
torpedo	torpedo
tracei	bullet
turbtrig	magnet
wasptrac	imagemissile
xarbgnd	explosion
xarbxpl	explosion
xarchbld	explosion
xarchcar	explosion
xarchgnd	explosion
xatmin	explosion
xbazfac	explosion
xbazfag	explosion
xblackg	explosion
xblackh	explosion
xblase	explosion
xblodht	explosion
xbulb2	explosion
xbulc2	explosion
xbulg2	explosion
xcarhadn	explosion
xchunki1	grenade
xchunki2	quakeblast
xchunki3	grenade
xchunki4	grenade
xchunkic	quakeblast
xchunkid	quakeblast
xchunks3	grenade
xchunkz	grenade
xclasbld	explosion
xclascar	explosion
xclasgnd	explosion
xcore	explosion
xcore2	spraybomb
xcore3	spraybomb
xcore4	spraybomb
xcore4	repairkit
xcorecar	explosion
xcoregnd	explosion
xcpcru	explosion
xdabomb	explosion
xdemosc	explosion
xdemosg	explosion
xdomrain	explosion
xdrbld_c	explosion
xdrcar_c	explosion
xdrgnd_c	explosion
xfbbld_c	explosion
xfbcar_c	explosion
xfbemit	explosion
xfbemit_c	explosion
xfbexp_c	explosion
xfbgnd_c	explosion
xfbseek	explosion
xfbseeke	explosion
xflaunch	explosion
xflmhit2	quakeblast
xflmhit3	explosion
xfocsbld	explosion
xfocscar	explosion
xfocsgnd	explosion
xgundep	quakeblast
xhailgnd	explosion
xhailxpl	explosion
xhcgbld	explosion
xhcgcar	explosion
xhcggnd	explosion
xhealbm	explosion
xhfire	explosion
xhmortgn	explosion
xhmortxp	explosion
xhydra	quakeblast
xincen	quakeblast
xioncco	explosion
xiongco	explosion
xisdf	quakeblast
xisdf2	quakeblast
xisdfc2	spraybomb
xisdfco	spraybomb
xisdfo	quakeblast
xisdfo2	grenade
xisdfob	quakeblast
xisdfs	explosion
xjam	explosion
xjammr	explosion
xkinetic	explosion
xlavad	spraybomb
xlavap	planarexpl
xlavar	explosion
xlazeb	explosion
xlazec	explosion
xlazeg	explosion
xlightd	explosion
xlightg	explosion
xlightr	explosion
xlitblt1	explosion
xlitblt2	explosion
xlitblt4	explosion
xlitblt5	explosion
xlitbltg	explosion
xlitbltv	explosion
xmirv	shockblast
xmirvbm	quakeblast
xmslcr2	explosion
xmslgn2	explosion
xnukegnd_b	explosion
xpballc	quakeblast
xpballg	explosion
xpballs	quakeblast
xplahit	explosion
xplsfrb	explosion
xplsfrg	explosion
xplsnipe	explosion
xpopbz2	explosion
xpopcar	explosion
xpopgnd	explosion
xpoptag	explosion
xradi	explosion
xraina	explosion
xrainl	explosion
xrainll	explosion
xrainr	explosion
xrainrr	explosion
xredfog	explosion
xreload	explosion
xsandcld	explosion
xsandsm	explosion
xsandwav	planarexpl
xsatxpl2	explosion
xsbazcar	explosion
xsbazgnd	explosion
xscion2	quakeblast
xscion3	quakeblast
xscionc2	spraybomb
xscions	explosion
xscorp	explosion
xscrpxpl	explosion
xshdwbld	explosion
xshdwcar	explosion
xshdwgnd	explosion
xshelcar	explosion
xshelgnd	explosion
xshield	explosion
xslagbld	explosion
xslagcar	explosion
xslaggnd	explosion
xslicbld	explosion
xsliccar	explosion
xslicgnd	explosion
xsprinkc	explosion
xsprinkg	explosion
xstalk	explosion
xstfcar	explosion
xstfgnd	explosion
xtechit	explosion
xtestcar	explosion
xtestgnd	explosion
xtoxic	explosion
xvent	explosion
xwater	explosion
xworm	quakeblast
xzomb	quakeblast
xzomb2	grenade
zvmech	walker
zvwing	wingman
1suser	sav
1ufigh	wingman
1ultnk	wingman
1utank	wingman
1vcnst2	constructionrig
1vrecy	recycler
2bmbld	supplydepot
2ufigh	wingman
2ultnk	wingman
2urckt	wingman
2utank	wingman
2uturr	wingman
2vcnst2	constructionrig
2vrecy	recycler
3bcafe	barracks
3bhqcp	i76building
3bhtowe	turret
3blpad	i76building
3blpow	powerplant
3bmbld	supplydepot
3bwpow	powerplant
3pwrck	daywrecker
3uapc	apc
3ufigh	wingman
3uhraz	wingman
3ultnk	wingman
3urckt	wingman
3utank	wingman
3uturr	wingman
3vcnst2	constructionrig
3vhaul	tug
3vrecy	recycler
aplstb	wpnpower
apphto	wpnpower
apudmgc	wpnpower
apudmgm	wpnpower
apudmgr	wpnpower
apuhulls	wpnpower
apuradar	wpnpower
apurelc	wpnpower
apurelm	wpnpower
apurelr	wpnpower
apuspcc	wpnpower
apuspcm	wpnpower
apuspcr	wpnpower
apuspdc	wpnpower
apuspdm	wpnpower
apuspdr	wpnpower
apuspeed	wpnpower
apustlth	wpnpower
aputurn	wpnpower
glazpnt	beamgun
glpstab	cannon
glstab	cannon
gphoto	cannon
gpopmrt	mortar
gupgrade	cannon
lazpoint	beam
level1	wingman
level2	wingman
level3	wingman
levelnope	wingman
photon	bolt
rocketl	rocket
sbhtowe	turret
sdrop	dropoff
smine1	scrapfield
wrock	grenade
aparba	wpnpower
arbalest	grenade
carbine	bolt
garblst	mortar
gatstbrw	cannon
gcrbn	cannon
ghailgn	cannon
gsminifl	beamgun
gxinigun	machinegun
gxinisov	cannon
gxktbomb	cannon
gxlast	cannon
gxolt	cannon
gxongun	machinegun
gxpstab	cannon
gxpstaba	cannon
gxpstabb	cannon
gxstbds	cannon
gxstbos	cannon
gxtstab	cannon
gxummy	machinegun
rbcom4	commtower
rbcom5	commtower
rbcom6	commtower
rbcom8	commtower
rbcon3	i76building
rbmbl4	supplydepot
rbmbl5	supplydepot
rbmbl6	supplydepot
rbmbl8	supplydepot
rbrw4i	i76building
rbrw8p	powerplant
rbrx16	supplydepot
rvhtnk	wingman
rvrckt	wingman
sminifls	beam
spcrbn	wpnpower
sphailg	wpnpower
spminifl	wpnpower
spstabrw	wpnpower
xcrbbld	explosion
xcrbcar	explosion
xcrbgnd	planarexpl
abr001	commtower
abrw6s	powerplant
absolj	powerplant
absolk	powerplant
absoll	powerplant
apnuke	ammopack
aprw3c	camerapod
aprw7k	daywrecker
asr001	person
asrw022	person
avharpy	wingman
avr001	wingman
avrw022	apc
bbrw6c	commtower
bbrw7c	i76building
bbrw8h	repairdepot
bbrw8s	supplydepot
bbrx17	i76building
bsrw7s	person
bsrwm3	person
bullx01	tracer
bvmrm	minelayer
bvrun3x	tug
bvrw6a	howitzer
bvrw6b	wingman
bvrw6r	wingman
bvrw6w	walker
bvrw6z	howitzer
bvrw7a	apc
bvrw7h	tug
bvrw8b	wingman
bvrw8t	wingman
bvrw8w	walker
bvrwm3	wingman
bvrwt3	wingman
bvrx16	wingman
bvrx17	apc
bvrx26	wingman
bvrx27	recycler
bvrx36	walker
bvrx37	factory
bvrx47	armory
bvrx57	wingman
bvrx67	wingman
cbrw5g	turret
cbrw5p	i76building
csrw4s	person
cvrw4a	apc
cvrw4f	wingman
cvrw4t	wingman
cvrw4y	turrettank
cvrw5h	wingman
cvrw5l	wingman
cvrw5r	wingman
cvrw5t	wingman
cvrw5x	wingman
cvrw5z	turrettank
gminix01	machinegun
grw8bolt	cannon
grwcup	cannon
grwnavb	dispenser
grzbolt	beamgun
gtartblt	cannon
hbbpas	artifact
hbrbm3	artifact
hvhar8	wingman
hvharpy	wingman
npcrr	i76sign
obcodx	artifact
obr001	artifact
obrcyc	i76building
obrw7h	i76building
obrwbh	i76building
obtgr1	i76building
ppammo	ammopack
pprepa	repairkit
proxrm03	proximity
proxrw05	proximity
proxrw7m	proximity
proxrw8m	proximity
prxold6	proximity
prxold7	proximity
rsgul1	person
rsr001	person
rsrw7a	person
rsrw8g	person
rsrwm4	person
rvap3	tug
rvap4	tug
rvapc5	apc
rvbaba	wingman
rvbyma	wingman
rvbymb	wingman
rvbyrw	wingman
rvcns4	constructionrig
rvcns5	constructionrig
rvcns6	constructionrig
rvcns8	constructionrig
rvdud4	wingman
rvhal3	tug
rvmuf4	factory
rvmuf5	factory
rvmuf6	factory
rvmuf8	factory
rvrc4a	recycler
rvrec4	recycler
rvrec5	recycler
rvrec6	recycler
rvrec8	recycler
rvreca	recycler
rvrw8h	tug
rvrx16	recycler
rvrx17	recycler
rvrx26	factory
rvrx27	factory
rvrx36	turrettank
rvrx37	armory
rvrx46	wingman
rvrx47	wingman
rvrx56	constructionrig
rvrx57	turrettank
rvslf3	armory
rvslf4	armory
rvslf5	armory
rvslf6	armory
rvslf8	armory
rvtnk3	wingman
rvtnk4	wingman
rvtnk5	wingman
rvtnk6	wingman
rvtnk8	wingman
rvtur4	turrettank
rvtur5	turrettank
rvtur6	turrettank
rvtur8	turrettank
rvzapp	turret
rw8bolt	bolt
rwzbolt	beam
sbgul1	barracks
spcrm7	camerapod
spcupr	wpnpower
sprwbm	wpnpower
sprwnv	camerapod
ssrw6s	person
svmort	wingman
svrw6s	tug
svrw8c	constructionrig
tartbolt	bolt
tartmine	weaponmine
ubrw8t	i76building
xrw7xpl	quakeblast
xrw8xpl	shockblast
xyp6xyl	shockblast
xyp7xyl	shockblast
aphwtz	wpnpower
apnsmg	wpnpower
aptag1	wpnpower
apvolc	wpnpower
ashd01	person
asrm01	person
assniper	person
avhd01	recycler
avhd02	factory
avhd03	scavenger
avhd04	wingman
avhd05	walker
avhd06	turrettank
avrm01	recycler
avrm02	turrettank
avrm03	wingman
avrm04	tug
avsav	wingman
bbns01	supplydepot
bbns02	repairdepot
bbns03	commtower
bbsila	scrapsilo
boltba	bolt
boltrf	bolt
bvbk01	armory
bvbk02	wingman
bvbk03	wingman
bvbk04	turrettank
bvbk05	tug
bvbm01	armory
bvbm02	factory
bvbm03	recycler
bvbm04	turrettank
bvbm05	wingman
bvbm06	wingman
bvbm07	wingman
bvbm08	wingman
bvbm09	turrettank
bvbo01	factory
bvbo02	armory
bvbo03	wingman
bvcns9	constructionrig
bvhrhc	wingman
bvlthc	wingman
bvmuhc	factory
bvns01	recycler
bvns02	factory
bvns03	armory
bvns04	constructionrig
bvns05	wingman
bvns06	wingman
bvns07	turrettank
bvns08	wingman
bvns09	walker
bvrehc	recycler
bvrf01	recycler
bvrf02	factory
bvrf03	armory
bvrf04	wingman
bvrf05	wingman
bvrf06	turrettank
bvrf07	wingman
bvrf08	wingman
bvsav	wingman
bvslhc	armory
bvsuper	wingman
bvtkhc	wingman
flamhd	flamepuff
flarhd	flare
flgn01	beam
gbolta	cannon
gboltrf	cannon
gdampns	radardamper
ghavoc	cannon
ghf001	beamgun
glgtng	cannon
gmagr01	cannon
gmagr02	cannon
gmagr03	cannon
gmaguna	chargegun
gphanta	imagerefract
grdflda	radardamper
gspdual	cannon
gtaggr1	targeting
gvolca	mortar
havoca	anchor
hbcube	artifact
hbhd01	i76building
hmina	weaponmine
obhvoc	weaponmine
proxmin4	proximity
proxns01	weaponmine
sbbk01	commtower
sbbm09	turret
sbbo01	turret
sbcohc	commtower
sbmbhc	supplydepot
sbns01	turret
sbrf01	turret
sbrf02	powerplant
sbrm01	turret
sbtohc	turret
spdual	rocket
sphf01	wpnpower
ssbk01	person
ssbk02	person
ssns01	person
ssrm01	person
ssushc	person
svarhv	howitzer
svbk01	constructionrig
svbk02	wingman
svbm01	recycler
svbm02	factory
svbm03	turrettank
svbm04	wingman
svbm05	wingman
svbm06	wingman
svfihc	wingman
svhd01	recycler
svhd02	factory
svhd03	turrettank
svhd04	scavenger
svhd05	wingman
svhd06	turrettank
svhd07	wingman
svhd08	wingman
svmuhc	factory
svns01	recycler
svns02	factory
svns03	wingman
svns04	wingman
svns05	turrettank
svns06	walker
svns07	howitzer
svns08	wingman
svns09	scavenger
svrehc	recycler
svrf01	recycler
svrf02	factory
svrf03	wingman
svrf04	turrettank
svrf05	turrettank
svrm01	turrettank
svtkhc	wingman
svtuhc	turrettank
swrmr1	missile
trembl	flare
tremora	seismic
volblst	grenade
volbomb	spraybomb
voldep	spraybomb
xmi4xpla	shockblast
xsulfur	explosion
apchoke	wpnpower
apheal	wpnpower
aphowz	wpnpower
aplgch	wpnpower
appaint	wpnpower
aprepz	repairkit
bslg01	person
bslg02	person
bull2lg	tracer
bvapcx	apc
bvartx	howitzer
bvcnsx	constructionrig
bvcnsz	constructionrig
bvhrax	wingman
bvlgga	wingman
bvlggb	wingman
bvlggc	wingman
bvlggd	wingman
bvlgge	walker
bvlggf	wingman
bvlggg	howitzer
bvlgnu	wingman
bvltnx	wingman
bvmdev	wingman
bvminx	minelayer
bvmufx	factory
bvmufz	factory
bvrazx	wingman
bvrckx	wingman
bvrecx	recycler
bvrecz	recycler
bvscax	scavenger
bvslfx	armory
bvtanp	wingman
bvtanx	wingman
bvturp	turrettank
bvturx	turrettank
bvturz	turrettank
bvwalx	walker
gchoke	targeting
glgchain	machinegun
gpaint	cannon
gsalvgun	beamgun
gsrkbomb	cannon
hbaphr	i76building
hbflyr	i76building
hbru01	i76building
hbru02	i76building
hbru03	i76building
hbru04	i76building
hbtowe	weaponmine
lbmbld	supplydepot
lgcubx	artifact
nplotg	i76sign
obnefa	i76building
obnehq	i76building
obrelc	artifact
proxlg01	proximity
rktpoint	missile
rockets2	rocket
sal01	beam
sbcoma	commtower
sbcomb	commtower
sbrlab	i76building
sbsupa	supplydepot
svafst	turrettank
svcnsz	constructionrig
svfta2	wingman
svftag	wingman
svhraza2	wingman
svhrazag	wingman
svhtut	turrettank
svlgga	turrettank
svlggb	wingman
svlggc	wingman
svlggd	wingman
svlgge	walker
svlggf	apc
svlggg	wingman
svlggh	apc
svlggi	wingman
svlggj	walker
svlggk	wingman
svlggl	wingman
svlggm	howitzer
svlggn	turrettank
svlggo	wingman
svltnz	wingman
svmu2ag	factory
svmuag	factory
svmufz	factory
svrecag	recycler
svrecyz	recycler
svslfz	armory
svtka2	wingman
svtkag	wingman
svwalka2	walker
svwalkag	walker
50cal	grenade
50he	explosion
50hegnd	planarexpl
sweeper1	machinegun
gsteerlk	cannon
steerlck	anchor
truxpl	explosion
biomsl	imagemissile
abecafe	weaponmine
basemine	proximity
bullete1	tracer
bullete2	tracer
ehwquake	seismic
epapc	wpnpower
epminiw	wpnpower
epprox	wpnpower
eprave	wpnpower
eprock	wpnpower
evartl0a	turrettank
evcarr1s	hover
evmuf0a	factory
evmuf0s	factory
evmuf1s	factory
evrecy0s	recycler
evrecy1s	recycler
executor	sav
exepilot	person
finish1	constructionrig
finish2	factory
finish3	armory
finish4	recycler
geasold	dispenser
gebomb	cannon
gecannon	cannon
gecminig	machinegun
gecminis	machinegun
gecminiw	machinegun
gecrave	cannon
gecsmoke	cannon
geexe	cannon
gehand	cannon
gehands	cannon
gephantm	imagerefract
geprox	dispenser
gerock	cannon
gessold	dispenser
geyser	flare
glaunch1	dispenser
glaunch2	dispenser
glaunch3	dispenser
glaunch4	dispenser
magneto	magnet
xehwxpl	quakeblast
xerkxpl	explosion
zebomb	rocket
zecannon	rocket
zecexe	flamepuff
zecminiw	tracer
zecrave	flamepuff
zecsmoke	rocket
zegeyser	flamepuff
zeprox	proximity
zerock	rocket
zetracer	tracer
zetraces	tracer
e2stab	rocket
fast2rkt	missile
g2bolt	cannon
g2estab	cannon
g2mdmine	detonator
g2missi	cannon
g2popgun	poppergun
ibhqcp	i76building
iv2apc	apc
iv2bike	wingman
iv2rckt	wingman
iv2tank	wingman
iv2user	person
md2mine	bouncebomb
menufix	wingman
mi2blda	i76building
mi2bldb	i76building
mi2bldc	i76building
overhang	i76building
scs2man	person
scv2pop	wingman
scv2tnk	wingman
tunnel	i76building
yakmine1	repairkit
yakmine2	repairkit
yakrepa	repairkit
xmark	explosion
bzpsp	wingman
bzpspg	wingman
bzpspm	wingman
drone	hover
gatbul	tracer
gatling	machinegun
gheavyc	cannon
glasmin	dispenser
grocket	cannon
gsent	dispenser
gun	cannon
guns	tracer
gunsent	cannon
gunsentb	tracer
jumppad	repairdepot
lasbeam	rocket
laser	turret
railgun	rocket
rock	thermalmissile
ruin1	i76building2
ruin2	i76building2
ruin3	i76building2
ruin4	i76building2
ruin5	i76building2
sblasr	turret
sentinel	turret
station	repairdepot
stationa	supplydepot
xcancar	explosion
xgatcar	explosion
xroccar	explosion
abbarrb1	bouncebomb
abbarrb2	bouncebomb
abbarrb3	bouncebomb
abbarrb4	bouncebomb
abbarrb5	bouncebomb
abbarrc1	quakeblast
abbarrc1	spraybomb
abbarrc2	quakeblast
abbarrc2	spraybomb
abbarrc3	quakeblast
abbarrc3	spraybomb
abbarrc4	quakeblast
abbarrc4	spraybomb
abbarrc5	quakeblast
abbarrc5	spraybomb
abgeneb1	bouncebomb
abgeneb2	bouncebomb
abgeneb3	bouncebomb
abgeneb4	bouncebomb
abgeneb5	bouncebomb
abgeneb6	bouncebomb
abgenec1	quakeblast
abgenec1	spraybomb
abgenec2	quakeblast
abgenec2	spraybomb
abgenec3	quakeblast
abgenec3	spraybomb
abgenec4	quakeblast
abgenec4	spraybomb
abgenec5	quakeblast
abgenec5	spraybomb
abgenec6	quakeblast
abgenec6	spraybomb
abtoweb1	bouncebomb
abtoweb2	bouncebomb
abtoweb3	bouncebomb
abtowec1	quakeblast
abtowec1	spraybomb
abtowec2	quakeblast
abtowec2	spraybomb
abtowec3	quakeblast
abtowec3	spraybomb
aienemy	explosion
aivsai	explosion
apamoreb	ammopack
apamorep	repairkit
apctrle1	explosion
apctrle2	explosion
apctrle3	explosion
apctrle4	explosion
apctrlf1	explosion
apctrlf2	explosion
apctrlf3	explosion
apctrlf4	explosion
apctrlpt	camerapod
apwrckb	daywrecker
asuse1	person
asuse2	person
avapcb1	bouncebomb
avapcb2	bouncebomb
avapcb3	bouncebomb
avapcc1	quakeblast
avapcc1	spraybomb
avapcc2	quakeblast
avapcc2	spraybomb
avapcc3	quakeblast
avapcc3	spraybomb
avartlb1	bouncebomb
avartlb2	bouncebomb
avartlb3	bouncebomb
avartlc1	quakeblast
avartlc1	spraybomb
avartlc2	quakeblast
avartlc2	spraybomb
avartlc3	quakeblast
avartlc3	spraybomb
avcnstb1	bouncebomb
avcnstb2	bouncebomb
avcnstb3	bouncebomb
avcnstb4	bouncebomb
avcnstc1	quakeblast
avcnstc1	spraybomb
avcnstc2	quakeblast
avcnstc2	spraybomb
avcnstc3	quakeblast
avcnstc3	spraybomb
avcnstc4	quakeblast
avcnstc4	spraybomb
avfighb1	bouncebomb
avfighc1	quakeblast
avfighc1	spraybomb
avhrazb1	bouncebomb
avhrazb2	bouncebomb
avhrazc1	quakeblast
avhrazc1	spraybomb
avhrazc2	quakeblast
avhrazc2	spraybomb
avltnkb1	bouncebomb
avltnkc1	quakeblast
avltnkc1	spraybomb
avmufb1	bouncebomb
avmufb2	bouncebomb
avmufb3	bouncebomb
avmufb4	bouncebomb
avmufb5	bouncebomb
avmufc1	quakeblast
avmufc1	spraybomb
avmufc2	quakeblast
avmufc2	spraybomb
avmufc3	quakeblast
avmufc3	spraybomb
avmufc4	quakeblast
avmufc4	spraybomb
avmufc5	quakeblast
avmufc5	spraybomb
avobserv	walker
avrcktb1	bouncebomb
avrcktc1	quakeblast
avrcktc1	spraybomb
avrecyb1	bouncebomb
avrecyb2	bouncebomb
avrecyb3	bouncebomb
avrecyb4	bouncebomb
avrecyc1	quakeblast
avrecyc1	spraybomb
avrecyc2	quakeblast
avrecyc2	spraybomb
avrecyc3	quakeblast
avrecyc3	spraybomb
avrecyc4	quakeblast
avrecyc4	spraybomb
avscavb1	bouncebomb
avscavb2	bouncebomb
avscavb3	bouncebomb
avscavb4	bouncebomb
avscavc1	quakeblast
avscavc1	spraybomb
avscavc2	quakeblast
avscavc2	spraybomb
avscavc3	quakeblast
avscavc3	spraybomb
avscavc4	quakeblast
avscavc4	spraybomb
avslfb1	bouncebomb
avslfb2	bouncebomb
avslfc1	quakeblast
avslfc1	spraybomb
avslfc2	quakeblast
avslfc2	spraybomb
avtanka	wingman
avtankb	wingman
avtankb1	bouncebomb
avtankb2	bouncebomb
avtankb3	bouncebomb
avtankb4	bouncebomb
avtankc	wingman
avtankc1	quakeblast
avtankc1	spraybomb
avtankc2	quakeblast
avtankc2	spraybomb
avtankc3	quakeblast
avtankc3	spraybomb
avtankc4	quakeblast
avtankc4	spraybomb
avtgtsys	howitzer
avturrb1	bouncebomb
avturrb2	bouncebomb
avturrb3	bouncebomb
avturrb4	bouncebomb
avturrc1	quakeblast
avturrc1	spraybomb
avturrc2	quakeblast
avturrc2	spraybomb
avturrc3	quakeblast
avturrc3	spraybomb
avturrc4	quakeblast
avturrc4	spraybomb
avwalkb1	bouncebomb
avwalkb2	bouncebomb
avwalkb3	bouncebomb
avwalkb4	bouncebomb
avwalkb5	bouncebomb
avwalkb6	bouncebomb
avwalkc1	quakeblast
avwalkc1	spraybomb
avwalkc2	quakeblast
avwalkc2	spraybomb
avwalkc3	quakeblast
avwalkc3	spraybomb
avwalkc4	quakeblast
avwalkc4	spraybomb
avwalkc5	quakeblast
avwalkc5	spraybomb
avwalkc6	quakeblast
avwalkc6	spraybomb
blas1	bolt
blastai	bolt
blc-matf	explosion
blc-matp	explosion
blc-pell	scrap
bomadenv	i76building2
bouncemm	grenade
bsuse1	person
bsuse2	person
bubblefd	explosion
bubblefp	explosion
bubblefx	explosion
bullet6c	tracer
bullet9a	tracer
bullet9b	tracer
bullet9c	tracer
bullet9s	tracer
bulletp1	tracer
bvobserv	walker
bvtanka	wingman
bvtankb	wingman
bvtankc	wingman
charge0	flamepuff
chrg0bld	explosion
chrg0car	groundblast
chrg0exp	explosion
chrg0gnd	groundblast
comrelyc	commtower
cpevnte0	explosion
cpevnte1	explosion
cpevnte2	explosion
cpevnte3	explosion
cpevnte4	explosion
cpevnte5	explosion
cpevnte6	explosion
cpevntf0	explosion
cpevntf1	explosion
cpevntf2	explosion
cpevntf3	explosion
cpevntf4	explosion
cpevntf5	explosion
cpevntf6	explosion
cppane1a	explosion
cppane1b	explosion
cppane1c	explosion
cppane1s	explosion
cppane2a	explosion
cppane2b	explosion
cppane2c	explosion
cppane2s	explosion
cppane3a	explosion
cppane3b	explosion
cppane3c	explosion
cppane3s	explosion
cppane4a	explosion
cppane4b	explosion
cppane4c	explosion
cppane4s	explosion
cppaned1	explosion
cppaned2	explosion
cppaned3	explosion
cppaned4	explosion
cppanee1	explosion
cppanee2	explosion
cppanee3	explosion
cppanee4	explosion
cppanef1	explosion
cppanef2	explosion
cppanef3	explosion
cppanef4	explosion
cppanes1	explosion
cppanes2	explosion
cppanes3	explosion
cppanes4	explosion
cppanfd1	explosion
cppanfd2	explosion
cppanfd3	explosion
cppanfd4	explosion
cppilo00	explosion
cppilo01	explosion
cppilo02	explosion
cppilo03	explosion
cppilo04	explosion
cppilo05	explosion
cpscrp00	explosion
cpscrp01	explosion
cpscrp02	explosion
cpscrp03	explosion
cpscrp04	explosion
cpscrp05	explosion
csuse1	person
csuse2	person
ctrlac01	explosion
ctrlac02	explosion
ctrlac03	explosion
ctrlac04	explosion
ctrlac05	explosion
ctrlac06	explosion
ctrlac07	explosion
ctrlac08	explosion
ctrlac09	explosion
ctrlac10	explosion
ctrlcape	explosion
ctrlcapf	explosion
ctrlcapi	explosion
ctrlpt00	explosion
ctrlpt01	explosion
ctrlpt02	explosion
ctrlpt03	explosion
ctrlpt04	explosion
ctrlpt05	explosion
ctrlpt06	explosion
ctrlpt07	explosion
ctrlpt08	explosion
ctrlpt09	explosion
ctrlpt10	explosion
ctrlpt11	explosion
ctrlpt12	explosion
ctrlpt13	explosion
ctrlpt14	explosion
ctrlpt15	explosion
ctrlpt16	explosion
ctrlpt17	explosion
ctrlpt18	explosion
ctrlpt19	explosion
ctrlpt20	explosion
ctrlptxx	explosion
ctrls	explosion
cutscrnb	explosion
cutscrng	explosion
cvapcb1	bouncebomb
cvapcb2	bouncebomb
cvapcc1	quakeblast
cvapcc1	spraybomb
cvapcc2	quakeblast
cvapcc2	spraybomb
cvartlb1	bouncebomb
cvartlb2	bouncebomb
cvartlc1	quakeblast
cvartlc1	spraybomb
cvartlc2	quakeblast
cvartlc2	spraybomb
cvcnstb1	bouncebomb
cvcnstb2	bouncebomb
cvcnstb3	bouncebomb
cvcnstb4	bouncebomb
cvcnstc1	quakeblast
cvcnstc1	spraybomb
cvcnstc2	quakeblast
cvcnstc2	spraybomb
cvcnstc3	quakeblast
cvcnstc3	spraybomb
cvcnstc4	quakeblast
cvcnstc4	spraybomb
cvfighb1	bouncebomb
cvfighb2	bouncebomb
cvfighc1	quakeblast
cvfighc1	spraybomb
cvfighc2	quakeblast
cvfighc2	spraybomb
cvhrazb1	bouncebomb
cvhrazb2	bouncebomb
cvhrazb3	bouncebomb
cvhrazc1	quakeblast
cvhrazc1	spraybomb
cvhrazc2	quakeblast
cvhrazc2	spraybomb
cvhrazc3	quakeblast
cvhrazc3	spraybomb
cvhtnkb1	bouncebomb
cvhtnkb2	bouncebomb
cvhtnkc1	quakeblast
cvhtnkc1	spraybomb
cvhtnkc2	quakeblast
cvhtnkc2	spraybomb
cvltnkb1	bouncebomb
cvltnkb2	bouncebomb
cvltnkb3	bouncebomb
cvltnkc1	quakeblast
cvltnkc1	spraybomb
cvltnkc2	quakeblast
cvltnkc2	spraybomb
cvltnkc3	quakeblast
cvltnkc3	spraybomb
cvmufb1	bouncebomb
cvmufb2	bouncebomb
cvmufb3	bouncebomb
cvmufc1	quakeblast
cvmufc1	spraybomb
cvmufc2	quakeblast
cvmufc2	spraybomb
cvmufc3	quakeblast
cvmufc3	spraybomb
cvobserv	walker
cvrcktb1	bouncebomb
cvrcktb2	bouncebomb
cvrcktb3	bouncebomb
cvrcktc1	quakeblast
cvrcktc1	spraybomb
cvrcktc2	quakeblast
cvrcktc2	spraybomb
cvrcktc3	quakeblast
cvrcktc3	spraybomb
cvrecyb1	bouncebomb
cvrecyb2	bouncebomb
cvrecyb3	bouncebomb
cvrecyb4	bouncebomb
cvrecyb5	bouncebomb
cvrecyc1	quakeblast
cvrecyc1	spraybomb
cvrecyc2	quakeblast
cvrecyc2	spraybomb
cvrecyc3	quakeblast
cvrecyc3	spraybomb
cvrecyc4	quakeblast
cvrecyc4	spraybomb
cvrecyc5	quakeblast
cvrecyc5	spraybomb
cvscavb1	bouncebomb
cvscavb2	bouncebomb
cvscavb3	bouncebomb
cvscavc1	quakeblast
cvscavc1	spraybomb
cvscavc2	quakeblast
cvscavc2	spraybomb
cvscavc3	quakeblast
cvscavc3	spraybomb
cvslfb1	bouncebomb
cvslfb2	bouncebomb
cvslfb3	bouncebomb
cvslfb4	bouncebomb
cvslfc1	quakeblast
cvslfc1	spraybomb
cvslfc2	quakeblast
cvslfc2	spraybomb
cvslfc3	quakeblast
cvslfc3	spraybomb
cvslfc4	quakeblast
cvslfc4	spraybomb
cvtnka	wingman
cvtnkb	wingman
cvtnkb1	bouncebomb
cvtnkb2	bouncebomb
cvtnkb3	bouncebomb
cvtnkb4	bouncebomb
cvtnkb5	bouncebomb
cvtnkc	wingman
cvtnkc1	quakeblast
cvtnkc1	spraybomb
cvtnkc2	quakeblast
cvtnkc2	spraybomb
cvtnkc3	quakeblast
cvtnkc3	spraybomb
cvtnkc4	quakeblast
cvtnkc4	spraybomb
cvtnkc5	quakeblast
cvtnkc5	spraybomb
cvturrb1	bouncebomb
cvturrb2	bouncebomb
cvturrb3	bouncebomb
cvturrc1	quakeblast
cvturrc1	spraybomb
cvturrc2	quakeblast
cvturrc2	spraybomb
cvturrc3	quakeblast
cvturrc3	spraybomb
desrten1	i76building2
domedarb	explosion
domedarr	explosion
ejectfxa	explosion
ejectfxb	explosion
ejectfxc	explosion
fgsnip_d	machinegun
fgsniz_d	machinegun
fixai2	rocket
flamexpl	explosion
flareb	flare
flarebfx	explosion
flarefxa	explosion
flarefxb	explosion
flarefxc	explosion
flarefxd	explosion
flarefxe	explosion
flareui	explosion
flareuib	explosion
flareuic	explosion
flashai	beam
flburnf2	explosion
flburnf3	explosion
flburnfx	explosion
fsnip_d	bullet
fsnip_dd	bullet
gamepaus	explosion
gatsaaa	cannon
gblastai	cannon
gcmda	cannon
gcmda	bolt
gcmdb	cannon
gcmdb	bolt
gcmdc	cannon
gcmdc	bolt
gcmdd	cannon
gcmdd	bolt
gcmde	cannon
gcmde	bolt
gflashai	beamgun
ghangm	mortar
ghartil1	mortar
ghartil2	mortar
ghartil3	mortar
ghartil4	mortar
ghartil5	mortar
ghartil6	mortar
ghartilp	mortar
ghornai	thermallauncher
gjetpack	machinegun
gmcurmim	dispenser
gmcurmin	mortar
gmdmgunm	mortar
gmitsmim	dispenser
gmitsmin	mortar
gmortlr	mortar
gobjplac	mortar
gpilomsg	machinegun
gpilomsh	cannon
gpilorkt	cannon
gproxb	dispenser
gquakeb	cannon
gredfldj	mortar
gredfldm	mortar
grenadlr	grenade
grktboai	cannon
gscava	cannon
gscava	bolt
gscavb	cannon
gscavb	bolt
gscavc	cannon
gscavc	bolt
gscavd	cannon
gscavd	bolt
gselecta	chargegun
gselectb	chargegun
gselectc	chargegun
gselecto	rocket
gselectp	rocket
gshadoz	imagelauncher
gsminia	machinegun
gsminib	cannon
gsminic	cannon
gsminis	machinegun
gspstabh	cannon
gspstabj	cannon
gspstabw	cannon
gsuppm	mortar
gtminisg	cannon
gvectorb	beamgun
gvectorr	beamgun
gvulcans	machinegun
handgunb	cannon
heatmsla	thermalmissile
impactzn	i76building2
jetpack	tracer
jetpackx	explosion
lastlife	explosion
lavasmok	explosion
lavaspew	explosion
loadarrl	explosion
loadarrr	explosion
loadouta	explosion
loadoutb	explosion
loadoutc	explosion
loadoutk	explosion
loadoutl	explosion
loadoutm	explosion
mcurbm	spraybomb
mcurfx	explosion
mcurfxb	explosion
mcurfxc	explosion
mcurfxd	explosion
mcurfxr	explosion
mcurspwn	i76building2
misn01a	explosion
misn01b	explosion
misn02	explosion
misn03	explosion
mitsdmg	explosion
mitsfxb	explosion
mitsfxc	explosion
mitsfxd	explosion
mitsfxe	explosion
mitsfxf	explosion
navrec2	explosion
navreci	explosion
navsen2	explosion
navsent	explosion
numt_0	explosion
numt_1	explosion
numt_2	explosion
numt_3	explosion
numt_4	explosion
numt_5	explosion
numt_6	explosion
numt_7	explosion
numt_8	explosion
numt_9	explosion
num_0	explosion
num_1	explosion
num_2	explosion
num_3	explosion
num_4	explosion
num_5	explosion
num_6	explosion
num_7	explosion
num_8	explosion
num_9	explosion
o2warna	explosion
o2warnb	explosion
observer	wingman
pacman	wingman
pchunka	explosion
pchunkb	explosion
pointl_b	explosion
pointl_d	explosion
pointl_g	explosion
pointl_p	explosion
pointl_r	explosion
pointl_t	explosion
pointl_w	explosion
pointl_y	explosion
prxmine	proximity
prxmineb	proximity
pteama	explosion
pteamb	explosion
rangevi2	explosion
rangevis	explosion
rktpilo	rocket
rocket3h	rocket
rocket3j	rocket
rocket3w	rocket
rocketai	rocket
sbpalvla	explosion
sbpalvlb	explosion
sbparpag	explosion
sbparpar	explosion
sbparpay	explosion
sbparpbg	explosion
sbparpbr	explosion
sbparpby	explosion
sbparpcg	explosion
sbparpcr	explosion
sbparpcy	explosion
sbpartag	explosion
sbpartar	explosion
sbpartbg	explosion
sbpartbr	explosion
sbpartcg	explosion
sbpartcr	explosion
sbpatknr	explosion
sbpbammo	explosion
sbpbrepa	explosion
sbpcnstf	explosion
sbpdown	explosion
sbpedita	wingman
sbpeditb	wingman
sbpeditc	wingman
sbpeditd	wingman
sbpfxphn	explosion
sbpfxphp	explosion
sbpfxphr	explosion
sbpfxrf	explosion
sbpgmpa	explosion
sbpgmpc	explosion
sbpgmpf	explosion
sbpgmpr	explosion
sbpnammo	explosion
sbpnbldg	explosion
sbpnrepa	explosion
sbpnupgr	explosion
sbprally	explosion
sbpralyi	explosion
sbpralyo	explosion
sbprcnst	explosion
sbprdcaf	explosion
sbprddaf	explosion
sbprddef	explosion
sbprddff	explosion
sbprdfaa	explosion
sbprdfaf	explosion
sbprdraf	explosion
sbprdrbf	explosion
sbprdrcf	explosion
sbprdrdf	explosion
sbprdref	explosion
sbprdrff	explosion
sbprdrft	explosion
sbprdrpf	explosion
sbprmine	explosion
sbprminf	explosion
sbpspwn	planarexpl
sbpspwna	explosion
sbpspwnb	explosion
sbpspwnc	explosion
sbpspwnd	explosion
sbpspwne	explosion
sbpspwnf	explosion
sbptgpab	explosion
sbptgpag	explosion
sbptgpar	explosion
sbptgpaw	explosion
sbptgpbb	explosion
sbptgpbg	explosion
sbptgpbr	explosion
sbptgpbw	explosion
sbptgpcb	explosion
sbptgpcg	explosion
sbptgpcr	explosion
sbptgpcw	explosion
sbptgtab	explosion
sbptgtag	explosion
sbptgtar	explosion
sbptgtaw	explosion
sbptgtbb	explosion
sbptgtbg	explosion
sbptgtbr	explosion
sbptgtbw	explosion
sbptgtcb	explosion
sbptgtcg	explosion
sbptgtcr	explosion
sbptgtcw	explosion
sbptugca	explosion
sbptugcb	explosion
sbptugcr	explosion
scrpblu1	scrap
scrpblu2	scrap
scrpblu3	scrap
scrpcls1	scrap
scrpcls2	scrap
scrpcls3	scrap
scrpcls4	scrap
scrporeb	turret
scrpred1	scrap
scrpred2	scrap
scrpred3	scrap
seismicb	seismic
sfieldb	scrapfield
sfieldc	scrapfield
shell1	grenade
shell2	grenade
shell3	grenade
shell4	grenade
shell4b	grenade
shell5	grenade
shell6	grenade
shelllr	grenade
sitecam	explosion
siz	powerplant
sizxpl	quakeblast
spawnref	i76building2
splalava	explosion
splashfx	explosion
ssuse1	person
ssuse2	person
standby	explosion
startdom	explosion
startdor	explosion
startdtr	explosion
startlgr	explosion
startltg	explosion
startltr	explosion
starttsg	explosion
starttsr	explosion
suse1am0	explosion
suse1am1	explosion
suse1am2	explosion
suse1am3	explosion
suse1am4	explosion
suse1am5	explosion
suse1am6	explosion
suse1am7	explosion
suse1am8	explosion
suse1am9	explosion
suse2am0	explosion
suse2am1	explosion
suse2am2	explosion
suse2am3	explosion
suse2am4	explosion
suse2am5	explosion
suse2am6	explosion
suse2am7	explosion
suse2am8	explosion
suse2am9	explosion
svapcb1	bouncebomb
svapcb2	bouncebomb
svapcb3	bouncebomb
svapcc1	quakeblast
svapcc1	spraybomb
svapcc2	quakeblast
svapcc2	spraybomb
svapcc3	quakeblast
svapcc3	spraybomb
svartlb1	bouncebomb
svartlb2	bouncebomb
svartlb3	bouncebomb
svartlb4	bouncebomb
svartlc1	quakeblast
svartlc1	spraybomb
svartlc2	quakeblast
svartlc2	spraybomb
svartlc3	quakeblast
svartlc3	spraybomb
svartlc4	quakeblast
svartlc4	spraybomb
svcnstb1	bouncebomb
svcnstb2	bouncebomb
svcnstb3	bouncebomb
svcnstb4	bouncebomb
svcnstb5	bouncebomb
svcnstb6	bouncebomb
svcnstc1	quakeblast
svcnstc1	spraybomb
svcnstc2	quakeblast
svcnstc2	spraybomb
svcnstc3	quakeblast
svcnstc3	spraybomb
svcnstc4	quakeblast
svcnstc4	spraybomb
svcnstc5	quakeblast
svcnstc5	spraybomb
svcnstc6	quakeblast
svcnstc6	spraybomb
svfighb1	bouncebomb
svfighb2	bouncebomb
svfighb3	bouncebomb
svfighc1	quakeblast
svfighc1	spraybomb
svfighc2	quakeblast
svfighc2	spraybomb
svfighc3	quakeblast
svfighc3	spraybomb
svhrazb1	bouncebomb
svhrazb2	bouncebomb
svhrazb3	bouncebomb
svhrazb4	bouncebomb
svhrazc1	quakeblast
svhrazc1	spraybomb
svhrazc2	quakeblast
svhrazc2	spraybomb
svhrazc3	quakeblast
svhrazc3	spraybomb
svhrazc4	quakeblast
svhrazc4	spraybomb
svltnkb1	bouncebomb
svltnkb2	bouncebomb
svltnkb3	bouncebomb
svltnkc1	quakeblast
svltnkc1	spraybomb
svltnkc2	quakeblast
svltnkc2	spraybomb
svltnkc3	quakeblast
svltnkc3	spraybomb
svmufb1	bouncebomb
svmufb2	bouncebomb
svmufb3	bouncebomb
svmufb4	bouncebomb
svmufc1	quakeblast
svmufc1	spraybomb
svmufc2	quakeblast
svmufc2	spraybomb
svmufc3	quakeblast
svmufc3	spraybomb
svmufc4	quakeblast
svmufc4	spraybomb
svobserv	walker
svrcktb1	bouncebomb
svrcktb2	bouncebomb
svrcktb3	bouncebomb
svrcktb4	bouncebomb
svrcktc1	quakeblast
svrcktc1	spraybomb
svrcktc2	quakeblast
svrcktc2	spraybomb
svrcktc3	quakeblast
svrcktc3	spraybomb
svrcktc4	quakeblast
svrcktc4	spraybomb
svrecyb1	bouncebomb
svrecyb2	bouncebomb
svrecyb3	bouncebomb
svrecyb4	bouncebomb
svrecyb5	bouncebomb
svrecyc1	quakeblast
svrecyc1	spraybomb
svrecyc2	quakeblast
svrecyc2	spraybomb
svrecyc3	quakeblast
svrecyc3	spraybomb
svrecyc4	quakeblast
svrecyc4	spraybomb
svrecyc5	quakeblast
svrecyc5	spraybomb
svscavb1	bouncebomb
svscavb2	bouncebomb
svscavb3	bouncebomb
svscavb4	bouncebomb
svscavc1	quakeblast
svscavc1	spraybomb
svscavc2	quakeblast
svscavc2	spraybomb
svscavc3	quakeblast
svscavc3	spraybomb
svscavc4	quakeblast
svscavc4	spraybomb
svslfb1	bouncebomb
svslfb2	bouncebomb
svslfb3	bouncebomb
svslfb4	bouncebomb
svslfc1	quakeblast
svslfc1	spraybomb
svslfc2	quakeblast
svslfc2	spraybomb
svslfc3	quakeblast
svslfc3	spraybomb
svslfc4	quakeblast
svslfc4	spraybomb
svtanka	wingman
svtankb	wingman
svtankb1	bouncebomb
svtankb2	bouncebomb
svtankb3	bouncebomb
svtankb4	bouncebomb
svtankb5	bouncebomb
svtankc	wingman
svtankc1	quakeblast
svtankc1	spraybomb
svtankc2	quakeblast
svtankc2	spraybomb
svtankc3	quakeblast
svtankc3	spraybomb
svtankc4	quakeblast
svtankc4	spraybomb
svtankc5	quakeblast
svtankc5	spraybomb
svturrb1	bouncebomb
svturrb2	bouncebomb
svturrb3	bouncebomb
svturrb4	bouncebomb
svturrb5	bouncebomb
svturrc1	quakeblast
svturrc1	spraybomb
svturrc2	quakeblast
svturrc2	spraybomb
svturrc3	quakeblast
svturrc3	spraybomb
svturrc4	quakeblast
svturrc4	spraybomb
svturrc5	quakeblast
svturrc5	spraybomb
svwalkb1	bouncebomb
svwalkb2	bouncebomb
svwalkb3	bouncebomb
svwalkb4	bouncebomb
svwalkc1	quakeblast
svwalkc1	spraybomb
svwalkc2	quakeblast
svwalkc2	spraybomb
svwalkc3	quakeblast
svwalkc3	spraybomb
svwalkc4	quakeblast
svwalkc4	spraybomb
title	explosion
titlebri	explosion
tracerb	tracer
transiti	explosion
txt0000g	explosion
txt0000r	explosion
txt0000y	explosion
txt0001g	explosion
txt0001r	explosion
txt0001y	explosion
txt0002g	explosion
txt0002r	explosion
txt0002y	explosion
txt0003g	explosion
txt0003r	explosion
txt0003y	explosion
txt0004g	explosion
txt0004r	explosion
txt0004y	explosion
txt0005g	explosion
txt0005r	explosion
txt0005y	explosion
txt0006g	explosion
txt0006r	explosion
txt0006y	explosion
txt0007g	explosion
txt0007r	explosion
txt0007y	explosion
txt0008g	explosion
txt0008r	explosion
txt0008y	explosion
txt0009g	explosion
txt0009r	explosion
txt0009y	explosion
txt0010g	explosion
txt0010r	explosion
txt0010y	explosion
txt0011g	explosion
txt0011r	explosion
txt0011y	explosion
txt0012g	explosion
txt0012r	explosion
txt0012y	explosion
txt0013g	explosion
txt0013r	explosion
txt0013y	explosion
txt0014g	explosion
txt0014r	explosion
txt0014y	explosion
txt0015g	explosion
txt0015r	explosion
txt0015y	explosion
txt0016g	explosion
txt0016r	explosion
txt0016y	explosion
txt0017g	explosion
txt0017r	explosion
txt0017y	explosion
txt0018g	explosion
txt0018r	explosion
txt0018y	explosion
txt0019g	explosion
txt0019r	explosion
txt0019y	explosion
txt0020g	explosion
txt0020r	explosion
txt0020y	explosion
txt0021g	explosion
txt0021r	explosion
txt0021y	explosion
txt0022g	explosion
txt0022r	explosion
txt0022y	explosion
txt0023g	explosion
txt0023r	explosion
txt0023y	explosion
txt0024g	explosion
txt0024r	explosion
txt0024y	explosion
txt0025g	explosion
txt0025r	explosion
txt0025y	explosion
txt0026g	explosion
txt0026r	explosion
txt0026y	explosion
txt0027g	explosion
txt0027r	explosion
txt0027y	explosion
txt0028g	explosion
txt0028r	explosion
txt0028y	explosion
txt0029g	explosion
txt0029r	explosion
txt0029y	explosion
txt0030g	explosion
txt0030r	explosion
txt0030y	explosion
txt0031g	explosion
txt0031r	explosion
txt0031y	explosion
txt0032g	explosion
txt0032r	explosion
txt0032y	explosion
txt0033g	explosion
txt0033r	explosion
txt0033y	explosion
txt0034g	explosion
txt0034r	explosion
txt0034y	explosion
txt0035g	explosion
txt0035r	explosion
txt0035y	explosion
txt0036g	explosion
txt0036r	explosion
txt0036y	explosion
txt0037g	explosion
txt0037r	explosion
txt0037y	explosion
txt0038g	explosion
txt0038r	explosion
txt0038y	explosion
txt0039g	explosion
txt0039r	explosion
txt0039y	explosion
txt0040g	explosion
txt0040r	explosion
txt0040y	explosion
txt0041g	explosion
txt0041r	explosion
txt0041y	explosion
txt0042g	explosion
txt0042r	explosion
txt0042y	explosion
txt0043g	explosion
txt0043r	explosion
txt0043y	explosion
txt0044g	explosion
txt0044r	explosion
txt0044y	explosion
txt0045g	explosion
txt0045r	explosion
txt0045y	explosion
txt0046g	explosion
txt0046r	explosion
txt0046y	explosion
txt0047g	explosion
txt0047r	explosion
txt0047y	explosion
txt0048g	explosion
txt0048r	explosion
txt0048y	explosion
txt0049g	explosion
txt0049r	explosion
txt0049y	explosion
txt0050g	explosion
txt0050r	explosion
txt0050y	explosion
txt0051g	explosion
txt0051r	explosion
txt0051y	explosion
txt0052g	explosion
txt0052r	explosion
txt0052y	explosion
txt0053g	explosion
txt0053r	explosion
txt0053y	explosion
txt0054g	explosion
txt0054r	explosion
txt0054y	explosion
txt0055g	explosion
txt0055r	explosion
txt0055y	explosion
txt0056g	explosion
txt0056r	explosion
txt0056y	explosion
txt0057g	explosion
txt0057r	explosion
txt0057y	explosion
txt0058g	explosion
txt0058r	explosion
txt0058y	explosion
txt0059g	explosion
txt0059r	explosion
txt0059y	explosion
txt0060g	explosion
txt0060r	explosion
txt0060y	explosion
txt0061g	explosion
txt0061r	explosion
txt0061y	explosion
txt0062g	explosion
txt0062r	explosion
txt0062y	explosion
txt0063g	explosion
txt0063r	explosion
txt0063y	explosion
txt0064g	explosion
txt0064r	explosion
txt0064y	explosion
txt0065g	explosion
txt0065r	explosion
txt0065y	explosion
txt0066g	explosion
txt0066r	explosion
txt0066y	explosion
txt0067g	explosion
txt0067r	explosion
txt0067y	explosion
txt0068g	explosion
txt0068r	explosion
txt0068y	explosion
txt0069g	explosion
txt0069r	explosion
txt0069y	explosion
txt0070g	explosion
txt0070r	explosion
txt0070y	explosion
txt0071g	explosion
txt0071r	explosion
txt0071y	explosion
txt0072g	explosion
txt0072r	explosion
txt0072y	explosion
txt0073g	explosion
txt0073r	explosion
txt0073y	explosion
txt0074g	explosion
txt0074r	explosion
txt0074y	explosion
txt0075g	explosion
txt0075r	explosion
txt0075y	explosion
txt0076g	explosion
txt0076r	explosion
txt0076y	explosion
txt0077g	explosion
txt0077r	explosion
txt0077y	explosion
txt0078g	explosion
txt0078r	explosion
txt0078y	explosion
txt0079g	explosion
txt0079r	explosion
txt0079y	explosion
txt0080g	explosion
txt0080r	explosion
txt0080y	explosion
txt0081g	explosion
txt0081r	explosion
txt0081y	explosion
txt0082g	explosion
txt0082r	explosion
txt0082y	explosion
txt0083g	explosion
txt0083r	explosion
txt0083y	explosion
txt0084g	explosion
txt0084r	explosion
txt0084y	explosion
txt0085g	explosion
txt0085r	explosion
txt0085y	explosion
txt0086g	explosion
txt0086r	explosion
txt0086y	explosion
txt0087g	explosion
txt0087r	explosion
txt0087y	explosion
txt0088g	explosion
txt0088r	explosion
txt0088y	explosion
txt0089g	explosion
txt0089r	explosion
txt0089y	explosion
txt0100	explosion
txt0101	explosion
txt0102	explosion
txt0103	explosion
txt0104	explosion
txt0105	explosion
txt0106	explosion
txt0107	explosion
txtbkdrg	explosion
txtblank	explosion
uic0001	explosion
uic0002	explosion
uic0003	explosion
uic0004	explosion
uic0005	explosion
uic0006	explosion
uic0007	explosion
uic0008	explosion
uic0009	explosion
uic0010	explosion
uic0011	explosion
uic0012	explosion
uic0013	explosion
uic0014	explosion
uic0015	explosion
undrwatr	explosion
unitmap	explosion
unitmap2	explosion
unitrec2	explosion
unitreci	explosion
unitsen2	explosion
unitsent	explosion
vectorb	beam
vectorr	beam
vvltnk	wingman
vvltnkr	wingman
vvtrnsf	explosion
vvtrnsfr	explosion
warnslfd	explosion
xbmbxplb	quakeblast
xchnkxpl	explosion
xflsbld	explosion
xflsbldb	explosion
xflscar	explosion
xflscarb	explosion
xflsgnd	planarexpl
xflsgndb	planarexpl
xgasxplm	explosion
xlgtbldp	explosion
xmcurxpl	shockblast
xmitsxpl	shockblast
xmslbldg	explosion
xmslbldp	explosion
xmslbldr	explosion
xmslcaer	explosion
xmslcarg	explosion
xmslcarp	explosion
xmslcarr	explosion
xmslgndg	planarexpl
xmslgndp	planarexpl
xmslgndr	planarexpl
xmslmabr	explosion
xmslmagr	explosion
bfg	rocket
bfgseek	grenade
bfgseek2	popper
bfgseek3	grenade
burnlast	grenade
dmchain	bullet
dmplasma	anchor
dmrocket	rocket
dmseis	seismic
doomguy	person
dvtank	wingman
dvtank02	wingman
fakammo2	spraybomb
fakammo3	spraybomb
fakammo3	ammopack
fakeammo	spraybomb
fakrep01	quakeblast
fakrep02	spraybomb
fakrep03	spraybomb
fakrep04	spraybomb
fakrep04	repairkit
fireburs	grenade
gauss	bolt
gauss2	bolt
gauss3	bolt
gbfg	cannon
gdmchain	cannon
gflame	cannon
ggauss	chargegun
gmelee	cannon
greload	snipergun
napalm	grenade
saw	torpedo
shotgun	bullet
xbeamhit	quakeblast
xbfggnd	explosion
xbfggrn	quakeblast
xbfghit	explosion
xbfgseek	explosion
xbfgtend	quakeblast
xburnlst	explosion
xdmcggnd	explosion
xdmcgveh	explosion
xdmplgnd	explosion
xdmplveh	explosion
xdmrkgnd	quakeblast
xdmrkveh	quakeblast
xdmsgveh	explosion
xdmssgnd	explosion
xfirebst	quakeblast
xflmgnd	quakeblast
xflmveh	quakeblast
xgauscar	explosion
xgausgnd	explosion
xglory1	explosion
xglory2	explosion
xnappud	quakeblast
xportal	explosion
xsaw	quakeblast
abbarx	i76building
abdrop	repairdepot
ablpadx	repairdepot
abstorsp	i76building
apangblt	wpnpower
apcmri	camerapod
aphade	wpnpower
aprpg	wpnpower
apsstbc	wpnpower
apwrckz	daywrecker
avapc26	tug
avartlf	howitzer
avdrop	turrettank
avhaul7	tug
avmuff	factory
bblpad30	i76building
bsuser23	person
bsuserco	person
bvapc09	tug
bvapc26	tug
bvcnst22	constructionrig
bvcnst30	constructionrig
bvcnst7	constructionrig
bvhaul30	tug
bvmtnk	wingman
bvmtnk30	wingman
bvmuf22	factory
bvmuf30	factory
bvmuf7	factory
bvrecy22	recycler
bvrecy27	recycler
bvrecy30	recycler
bvrecy7	recycler
bvslf30	armory
bvslfz	armory
bvtank1	wingman
fireball	rocket
gfirebal	cannon
grpg	cannon
gsnipe23	snipergun
gvangblt	cannon
gxinisov	machinegun
hbbird	i76building
hbcham	artifact
hbcore	artifact
hbgate	i76building
hblaba	i76building
hvngrd	wingman
rpg	rocket
sbhangrb	repairdepot
sbhqcpa	i76building
sbspow09	powerplant
sbspowg	powerplant
sbtowerb	turret
sdome	explosion
snipe23	snipershell
svartlf	howitzer
svhaul7	tug
svmamm	wingman
svmtnk	wingman
svmtnkd	wingman
vangbolt	bolt
xbalxpl	explosion
xbmbblnd	quakeblast
xrpgxpl	explosion
abbomb	i76building
bsian02	person
cshop	person
cspla2	person
cssoldg	person
csuser1	person
gcian05	scrap
gsnipe2	cannon
iancmne1	proximity
iancmne3	proximity
iannmne5	proximity
ianrel01	artifact
sbport	portal
sshop	person
sspilo2	person
sspiloi	person
sspiloi2	person
sssnipe	person
sssold2	person
tritongy	explosion
xcrate	explosion
xtimxpl	quakeblast
asnipe	person
aspcmn	person
sspcmn	person
apbltx	wpnpower
boltminx	weaponmine
gbltminx	dispenser
avamp2	howitzer
avmimp	minelayer
avtmp2	turrettank
bvarmp	howitzer
bvmimp	minelayer
bvtmp2	turrettank
svamp2	howitzer
svmimp	minelayer
svtmp2	turrettank
apbstr	wpnpower
apphot	wpnpower
blaster	rocket
gblaster	cannon
gphoton	mortar
photon	grenade
xptnxpl	shockblast
avdrop	sav
avtanf	wingman
sbtowt	turret
avmysc	scavenger
svking	wingman
avrecg	recycler
sbtowg	turret
svcnsg	constructionrig
svmufg	factory
svrecg	recycler
svscag	scavenger
svtang	wingman
svturg	turrettank
svwalg	walker
apwr02	daywrecker
apwr03	ammopack
gwrkr01	dispenser
gwrkr02	dispenser
hbwr01	i76building
proxwr01	proximity
sswr02	person
sswr03	person
sswr04	person
svdayw	howitzer
wmsgtur1	turrettank
wmsgtur2	turrettank
wmsgtur3	turrettank
wmsgtur4	turrettank
xwrkxp2	quakeblast
sbg100	turret
svf100	wingman
svf110	sav
svm100	factory
svr100	recycler
apenam	ammopack
apenrp	repairkit
avenfi	wingman
avenfy	factory
avenry	recycler
aventk	wingman
aventr	turrettank
spenam	ammopack
spenrp	repairkit
svenfi	wingman
svenfy	factory
svenry	recycler
sventk	wingman
sventr	turrettank
boltpush	weaponmine
gmvmcur	dispenser
sbmvg1	turret
sbmvg2	turret
svmvfi	wingman
svmvfy	sav
svmvk1	wingman
svmvk2	wingman
svmvmf	factory
svmvry	recycler
svmvsv	scavenger
svmvt1	turrettank
svmvt2	turrettank
sbtowf	turret
svmug	factory
svtnka	wingman
svtura	turrettank
mufbak	factory
xvmuf	factory
xvtank	wingman
arrlz1	weaponmine
arrlz2	proximity
apbiomsl	wpnpower
apbrstg	wpnpower
aplasgun	wpnpower
apmeteor	wpnpower
apmteorl	wpnpower
apresp	daywrecker
apwaspo	wpnpower
avdron	wingman
avhtnko1	wingman
avmufk	factory
avreck	recycler
avreckl	recycler
avreckw	recycler
avslfs	armory
bulletp	tracer
bvmtnko1	wingman
bvmufbi	factory
bvslfs	armory
cvmufia	factory
cvrecyia	recycler
cvslfs	armory
dvslfs	armory
evraz	wingman
fvbsct	wingman
fvcnsts	constructionrig
fvcnstw	constructionrig
fvrecys	recycler
fvrecyw	recycler
fvslfs	armory
gbiomsl	cannon
gburstgn	cannon
glasgun	beamgun
gplsr	cannon
gqtstab	cannon
gx2nisov	cannon
gx2pstab	cannon
gxinigun	cannon
gxtstaba	cannon
gxtstabt	cannon
hbbecn	i76building
lasgun	beam
meteornc	spraybomb
meteornf	spraybomb
mvhtnk	wingman
mvslfs	armory
respgre2	spraybomb
respgren	spraybomb
resplmgr	spraybomb
resplmi2	flare
resplmi3	flare
resplmin	flare
rvslfs	armory
spboltc	wpnpower
sppmml	wpnpower
svmffa	factory
svmtnko1	wingman
svmuffm	factory
svmufm	factory
svrecf	recycler
svrecfs	recycler
svrecfw	recycler
svrecm	recycler
svrecml	recycler
svrecms	recycler
svrecmw	recycler
svrefa	recycler
svslff	armory
svslffs	armory
svslfs	armory
xresuppl	quakeblast
abstoz	artifact
atranp	tug
gengtl	beamgun
sssolz	person
weldfl	beam
xlaseng	explosion
bullet1	snipershell
bullet1g	snipershell
bullet2	snipershell
bullet5	snipershell
bullet6	snipershell
xgasxpl	shockblast
xminxpl	shockblast
abtowe08	turret
assold08	person
avapc08	apc
blast08	bolt
bullet08	tracer
gblast08	cannon
gtmini08	machinegun
svapc08	apc
svfigh08	wingman
svhraz08	wingman
svltnk08	wingman
svrckt08	wingman
svtank08	wingman
4suser	person
5suser	person
6suser	person
7suser	wingman
8suser	person
9suser	person
s3pull	magnet
wind1	proximity
wind2	proximity
wind3	proximity
wind4	proximity
ampo	ammopack
reparo	repairkit
ygbmrat1	wpnpower
ygbmrat2	cannon
ygbmrat3	rocket
ygjerok1	wpnpower
ygjerok2	cannon
ygpopm1	wpnpower
ygpopm2	dispenser
ygpopm3	weaponmine
ygrok1a	wpnpower
ygrok1b	imagelauncher
ygrok2a	wpnpower
ygrok2b	targeting
ygrok3a	wpnpower
ygrok3b	cannon
ygrok4a	wpnpower
ygrok4b	thermallauncher
ygrok5a	wpnpower
ygrok5b	radarlauncher
ygrok6a	wpnpower
ygrok6b	cannon
ygtank	wingman
avtra1	turrettank
prtra1	proximity
svsto1	turrettank
svsto2	wingman
svsto3	wingman
svsto4	wingman
grktbomb	radarlauncher
avret5	recycler
avtestb	turrettank
drocket	rocket
gdatstab	cannon
nparr05	i76sign
xconfeti	explosion
apacstab	wpnpower
apbumper	wpnpower
apchstab	wpnpower
apfmine	wpnpower
apfthrow	wpnpower
apmega	wpnpower
apnapalm	wpnpower
apnitro	wpnpower
appopr	wpnpower
apqmine	wpnpower
apshtgun	wpnpower
apsnipg	wpnpower
apthndr	wpnpower
apvirus	wpnpower
bullet8	tracer
bullet9	rocket
chrono	anchor
concmort	spraybomb
flame2	flamepuff
flame3	flamepuff
flasmine	weaponmine
gacstab	targeting
gbumper	dispenser
gchstab	cannon
gfmine	dispenser
gfthrow	cannon
gmegagun	cannon
gnapalm	mortar
gnitro	cannon
gpopr	poppergun
gqmine	dispenser
gshtgun	cannon
gsnipg	cannon
gthndr	cannon
gvirus	thermallauncher
napalm	spraybomb
nitro	anchor
popper2	popper
qmine	flare
rocket4	rocket
swarmer2	missile
thunder	bolt
virus	thermalmissile
glazor	beamgun
lazor	beam
bsbatprs	person
bvbatrec	recycler
sbbatshl	shieldtower
ssbatsnp	person
svbattur	turrettank
ccagun	cannon
cragun	cannon
handgun	machinegun
handgunc	machinegun
handguns	machinegun
nsdfgun	cannon
pshell	tracer
pshellc	tracer
pshells	tracer
tracer	flamepuff
tracerc	flamepuff
tracers	flamepuff
ghrdef	thermallauncher
hrdef	thermalmissile
asuser18	person
ccagun	machinegun
cragun	machinegun
csuser18	person
hg18	cannon
hgc18	cannon
hgs18	cannon
nsdfgun	machinegun
ssuser18	person
gmdmgun	cannon
avfigh1	wingman
chickbox	weaponmine
chickegg	rocket
feathrbm	spraybomb
feathrpf	flamepuff
flarex	flare
gchikmin	dispenser
gegggun	cannon
gsplintx	mortar
hpchk1	ammopack
hpchk2	ammopack
hpchk3	ammopack
hpchk4	ammopack
hpchk5	ammopack
hvtruk	wingman
sbchkd	repairdepot
sbcrat	i76building
sbstor	i76building
xchkbld	explosion
xchkcar	explosion
xchkgnd	planarexpl
xpofxpl	explosion
xpufxpl	explosion
svtaki	wingman
abtowr	supplydepot
avapcdem	apc
sbnit1	scrapsilo
svnit1	turrettank
svnit3	wingman
svnit4	wingman
svnit5	wingman
svkik1	turrettank
svkik2	howitzer
svkik3	wingman
sbmac1	powerplant
sbmac2	turret
svmac1	turrettank
svmac2	turrettank
svmac3	howitzer
svmac4	wingman
svmon1	turrettank
svmon2	wingman
1vhaul	tug
2vhaul	tug
3pammo	ammopack
3prepa	repairkit
apsstbb	wpnpower
gtminic	machinegun
bvreds	wingman
bvredc	wingman
gshadowb	imagelauncher
imagmslb	imagemissile
boltmix	weaponmine
gboltmix	dispenser
bulltsgt	tracer
flashsgt	beam
gflshsgt	beamgun
gminisgt	machinegun
adome	explosion
asuserbg	person
avtestbg	turrettank
bldgodmp	wingman
csuserbg	person
ddome	explosion
gharv	cannon
gomniprs	terrainexpose
gragnar	mortar
grdlance	beamgun
gswarmer	cannon
harvord	beam
lanceord	bolt
ragord	grenade
ssuserbg	person
swarmera	missile
xraggnd	explosion
xragxpl	explosion
xswrmbld	explosion
xswrmcar	explosion
xswrmgnd	planarexpl
gatstabv	cannon
rocketv	bullet
svrwtp	wingman
bulletx	tracer
ghevyg	machinegun
seismicx	seismic
super0	walker
super1	walker
super2	walker
super3	walker
super4	walker
super5	walker
super6	walker
super7	walker
super8	walker
super9	walker
avcnst_n64_1	constructionrig
avcnst_n64_3	constructionrig
avcnst_n64_4	constructionrig
avcnst_n64_5	constructionrig
avmuf_n64_1	factory
avmuf_n64_2	factory
avmuf_n64_3	factory
avmuf_n64_4	factory
avmuf_n64_5	factory
avrecy_n64_1	recycler
avrecy_n64_2	recycler
avrecy_n64_3	recycler
avrecy_n64_4	recycler
avrecy_n64_5	recycler
avrecy_n64_6	recycler
avrecy_n64_7	recycler
avrecy_n64_8	recycler
svmuf_n64_1	factory
svmuf_n64_2	factory
svmuf_n64_3	factory
svrecy_n64_1	recycler
svrecy_n64_2	recycler
svrecy_n64_3	recycler
svrecy_n64_6	recycler
svrecy_n64_5	recycler
svrecy_n64_6	recycler
svscav_n64_1	scavenger
avrecy_n64_9	recycler
svrecy_n64_7	recycler
bvrecy_n64_1	recycler
bvrecy_n64_2	recycler
bvrecy_n64_3	recycler
svslf_n64_ammo_hull_only	armory
svmammoth	wingman
